the height of irony - используется, чтобы описать ситуацию, в которой происходит противоположное ожидаемому, или когда результат ситуации является полной противоположностью того, чего кто-то ожидал или на что надеялся ???

heinous - говоря про что-то нехорошее, например, преступление, очень злое или безнравственное; отвратительное

a hiatus - пауза, в течение которой ничего не происходит, или промежуток, в течение которого чего-то не хватает

abject - 1) говоря про ситуацию или качество, крайне плохое; крайний (например, нищета), полный (например, крах)
2) говоря про кого-то, неимеющий мужества или уважения к себе; отвратительный

pious - твердо верующий в религию и живущий так, чтобы это демонстрировалось; благочестивый, набожный

posh - 1) дорогой и используемый или принадлежащий богатым людям
2) имеющий отношение к высокому социальному классу

vapid - скучный и неинтересный; безвскусный, банальный

a numeracy - способность выполнять арифметические действия; числовая грамотность

a serfdom - крепостное право

a demise - кончина, смерть

a trapezoid / a trapezium - трапеция

a desiderium - сильное желание или тоска, особенно по чему-то, что когда-то было

to fudge something - избегать принятия решения или дачи четкого ответа о чем-то; уклоняться от ответа

a cumin - зира

to prance - ходить энергично и с большим количеством движений, чем необходимо; скакать, вваливаться, гарцевать

to knead something - сильно и многократно сдавливать что-то, особенно смесь для выпечки хлеба, руками и пальцами; месить

to break the mould / to break the mold - внести изменения, которые разрушают устоявшуюся привычку, шаблон и так далее

a coinage - 1) набор монет разного достоинства, используемых в денежной системе страны
2) чеканка монет
3) изобретение нового слова или фразы в языке или само слово или фраза

to sag - провисать или вызывать провисание по частям, например, под тяжестью или давлением

an uproar - ситуация, в которой множество людей сердито жалуются на что-то или сильно шумят; волнение, переполох, шум

soggy - говоря про вещи, которые могут впитывать воду, особенно еда, неприятно влажная и мягкая; размокший

to relapse - заболеть или снова начать вести себя плохо после улучшения; сорваться

to baste something - поливать мясо горячим жиром и жидкостью во время приготовления

to belay someone - контролировать веревку, к которой прикреплен альпинист, и поддерживать ее натянутой, чтобы в случае падения альпинист не упал слишком далеко; подстраховать

a repose - состояние отдыха или лежания

a vineyard - виноградник

a satchel - прямоугольная кожаная сумка с длинным ремешком, в прошлом ее использовали в основном дети для переноски книг в школу; ранец, сумка

compulsory - обязательный для выполнения из-за правила или закона

an animal husbandry - разведение животных для производства продуктов питания, таких как мясо, яйца и молоко; животноводство

appalling - настолько плохой или неприятный что это вас шокирует; ужасный

a tulip - тюльпан

daunting - заставляющий вас немного бояться или беспокоиться о том, как с чем-то справиться; пугающий

a noose - петля

a dendrite - дендрит

to sleep in - спать утром дольше, чем обычно

a keepsake - небольшой подарок, обычно недорогой, который вам кто-то дарит, чтобы вы запомнили этого человека; подарок на память

to swill out something - очистить что-то, поливая водой; промыть

to delaminate something - расслаивать что-то

a compactor - машина, которая измельчает материал, особенно отходы, чтобы он помещался в меньшем пространстве; уплотнитель

a trash compactor - мусоросборник

a quid - фунт

a lodger - тот, кто платит за место для сна, а также, как правило, за еду в чужом доме; квартирант

a porcelain - фарфор

a parity  - паритет

a bridegroom - мужчина, который собирается жениться или только что женился; жених

a grime - грязь, которая скопилась на поверхности чего-то

a fjord - фьорд

resilient - способный легко и быстро восстанавливаться после неприятных или разрушительных событий; устойчивый

a bedpost - один из четырех угловых столбов, которые поддерживают кровать

a scapula - говоря про анатомию, лопатка

an assent to something - официальное согласие или одобрение идеи, плана или запроса; согласие, знак согласия

bedridden - вынужденный оставаться в постели из-за болезни или травмы; прикованный к постели

to curdle - говоря про молоко или яйца, сворачиваться

a clot - почти твердый кусок чего-то; сгусток

a greenery - зеленые растения или ветки, особенно срезанные и используемые в качестве украшения; зелень

selcouth - необычный, странный, непривычный, малоизвестный, незнакомый, новый, редкий (устаревшее)

a serendipity - инстинктивная прозорливость, интуитивная прозорливость, серендипность

a cumulonimbus - кучево-дождевые облака

destitute - неимеющий денег, еды, дома и имущества; без средств к существованию

to flit - говоря про птиц, быстро перелетать из одного места в другое

a bleacher - наклонная зона сидений на спортивной площадке, которая не имеет никакой крыши и поэтому недорогая, чтобы там сидеть; трибуна

a muzzle - говоря про животное, морда или намордник

a withers - холка

tipsy - слегка пьяный

a crest - 1) нарост перьев, меха или кожи на верхней части головы у некоторых животных; гребень
2) верхняя или самая высокая часть чего-то, например, волны или холма; гребень
3) украшение, обычно из перьев или шерсти животных, на верхушке солдатской шляпы, особенно в прошлом; гребень

a bridle - уздечка

a graze - повреждение поверхности кожи, вызванное трением ее о что-то грубое; ссадина

to shuck something - удалить скорлупу или естественное покрытие с чего-то, что употребляется в пищу

a suede - велюр

a grift - способы получения денег нечестным путем, включающие обман

to fall short of/by something - не достичь какого-то объема или стандарта, которого ожидали или на который надеялись, вызывая разочарование; не оправдать ожиданий, не добрать чего-то

to preen - 1) говоря про птиц, чистить и приводить в порядок свои перья с помощью клюва
2) тратить время на то, чтобы выглядеть привлекательно; прихорашиваться

a trabecula - трабекула

a ditty - особенно простая и неискушенная песня; песенка

a yew - вечнозеленое дерево с плоскими листьями, похожими на иголки, и маленькими красными плодами; тис

a bilge - 1) нижняя внутренняя часть корабля, где собирается грязная вода; трюм
2) чепуха, чушь

a hooch - крепкий алкоголь, особенно виски; самогон

wired / wired up - нервничающий или взволнованный, например, из-за будущего события или потому, что вы выпили кофе или приняли наркотики; взвинченный

a quail - перепел

a prang - дорожно-транспортное происшествие, в котором транспортные средства получили лишь незначительные повреждения

a petrichor - петрикор

second-rate - имеющий не самое лучшее качество; второсортный

a gloaming - поэтическое слово "twilight", или время суток сразу после захода солнца; сумерки

a fugleman - 1) человек, который выступает в роли лидера или примера
2) солдат, используемый в качестве примера для тех, кто учится строевой подготовке

a cytotoxin - цитотоксин

a mephitis - 1) вредный, дурно пахнущий пар из земли, например, испарения от разлагающихся органических веществ или ядовитый газ из шахты
2) самнитская и римская богиня, охраняющая от вредных испарений; Мефитис

a quinquennium - период в пять лет; пятилетие, пятилетка

in spades - в больших количествах или в очень большой степени

enticing - невероятно привлекательное и вызывающее желание приобрести это или заняться этим; заманчивый

a cottage cheese - зерненый творог

to abscond from somewhere - сбежать откуда-то, обычно без разрешения

to clamber - с трудом карабкаться, перелезать или проникать куда-то, используя руки и ноги

a sickle - серп

an effervescence - 1) образование или наличие пузырьков газа в жидкости, или сами пузырьки; бурление
2) состояние активности, позитива и энергии; бурлящая энергия

a defenestration - дефенестрация

a telltale / a tattletale - человек, особенно ребенок, который тайно говорит облеченному властью, особенно учителю, что кто-то другой сделал что-то плохое, часто с целью причинить неприятности; ябеда

an ultracrepidarian - тот, кто не обладает особыми познаниями в предмете, но высказывает свое мнение о нем

a quincunx - квинкункс

a prudence - благоразумие

a rind - кожура такого фрукта, как лимон или апельсин; кожура

ineffable - вызывающий столько эмоций, особенно удовольствия, что это невозможно описать; невыразимый

on the sidelines - не принимая в чем-то участие

to adjudicate on something - выступать судьей в соревновании или споре, или принимать официальное решение по чему-то

to regugitate something - повторять идеи или факты, не до конца понимая их

a constipation - замедленная, затрудненная или систематически недостаточная дефекация; запор, констипация, обстипация

lofty - говоря про идеи, идеалы или амбиции, соответствующие высоким моральными стандартам и достойные восхищения ; великий, высокий, возвышенный

to have an inkling - иметь смутное представление о чем-то или подозревать что-то

a gait - походка

to extol someone or something - очень сильно хвалить кого-то или что-то; восхвалять

an abstract of something - говоря про документы, статью или какую-то речь, краткий текст, излагающий основные положения

bashful - часто чувствововающий себя неловко в присутствии других людей и легко смущающийся; застенчивый

a celerity - скорость (устаревшее)

a clergy - духовенство

stirring - говоря про речь, песню, событие, выступление или рассказ, вызывающий глубокое волнение, энтузиазм и сильные позитивные эмоции; захватывающий, впечатляющий

a tinsel - мишура

luscious - 1) говоря про человека, сексуально привлекательный; соблазнительный
2) говоря про еду, очень сочная и вкусная
3) говоря про территорию, содержащая много зеления и красиво выглядящая; роскошный
4) приятный на вид, слух или ощупь; роскошный

a doohickey - любой небольшой предмет или устройство, название которого неизвестно или временно забыто; штуковина, приспособление

a facetiousness - несерьезное отношение к чему-то серьезномы, в попытке показаться смешным или умным, особенно в неподходящее время; несерьезность

a quagmire - 1) мягкий, мокрый участок земли, в который проваливаются ноги, при попытке по нему пройти; трясина, болото
2) сложная, запутанная или неприятная ситуация, которую нелегко избежать или из которой нелегко выбраться; трясина, болото

a finesse - большое мастерство и стиль; изящность

wily - хорошо разбирающийся в ситуациях, возможностях и людях, часто готовый использовать уловки для достижения цели; хитрый

a tomfoolery - игривое поведение, обычно довольно глупое, шумное или грубое; дурачество

a slate - аспидный сланец

to quail - чувствовать или проявлять страх так, что хотеть отстраниться от чего-то; дрожать от страха

a crepe - 1) креп
2) тонкий и легкий блин
3) прочный вид резины с шероховатой поверхностью, используемый, в частности, для изготовления подошв обуви

a brawn - физическая сила и большие мышцы

white-knuckle - говоря про какой-то опыт, очень захватывающый и одновременно очень пугающий; напряженный

a mothball - небольшие шарики химического пестицида и дезодоранта, иногда используемые при хранении одежды и других материалов, подверженных порче чешуйницами, плесенью или личинками моли; нафталиновый шарик

to put something in mothballs - откладывать что-то на неопределённый срок или на очень долгий срок, например перевести что-то в состояние хранения или в резерв

a wisteria - глициния

shabby - старый и в плохом состоянии из-за долгого использования или отсутствия ухода; обветшалый, потрепанный, обшарпанный

a disuse - состояние объекта, когда он давно перестал быть используемым; простой, запустение

woozy - чувствововающий слабость или недомогание и неспособный ясно мыслить; чувствововающий головокружение, одурманенный

a moniker - сленговое слово для имени, прозвища или псевдонима

to subjugate someone - устанавливать над кем-то полный контроль, особенно побеждая в войне; подчинять

to be subjugated to something - говоря про желания или стремления, считататься менее важными, чем что-то другое

a sylph - 1) сильф, сильфида
2) стройная изящная девушка или молодая женщина

a hilum - углубление или борозда, через которую такие структуры, как кровеносные сосуды и нервы, входят в орган

a cynic - циник

arguably - используется, когда высказывается свое мнение или убеждение с целью придать ему большую весомость; пожалуй, возможно

to besmirch someone or something - очернять кого-то или что-то

a brim - 1) нижняя часть шляпы, выступающая за пределы головы; поле шляпы, край шляпы
2) самый верхний край контейнера

to brim with something - наполнять что-то чем-то или быть полным чем-то до краев

to exsanguinate - обескровить

an exsanguination - кровопотеря

a silo - 1) высокая круглая металлическая башня на ферме, в которой хранится трава, зерно или другие материалы; силос
2) специально построенное под землей место, где хранится ядерная ракета; подземная шахта

a fusillade - большое количество выстрелов или брошенных предметов одновременно; шквал

a pyre - погребальный костер

a needlepoint - создание вышивки или сама вышивка

a craze for something - деятельность, вещь или идея, которые пользуются огромной популярностью, как правило, в течение короткого времени; мода на что-то, модный тренд на что-то, помешательство на чем-то

a thrift - бережливое использование денег, особенно путем избегания расточительства; бережливость

a thrift shop/store - магазин, который продает бывшие в употреблении товары по дешевке и отдает прибыль благотворительным организациям; комиссионный магазин, секонд-хенд

a thyme - тимьян

a vibrissa - вибриссы

sultry - говоря о погоде, неприятно теплая и слегка влажная; знойная

a dunce - мягкое оскорбление, означающее, что какой-то человек туго учится или глуп

a polynomial - многочлен в математике

to go limp - терять силу, энергию или напряжение, становясь слабым, безжизненным или теряющим сознание

slick - 1) говоря про выступление, постановку или рекламу, качественная и впечатляющая
2) говоря про действие, выполненное быстро и плавно, будто не прилагая каких-либо усилий; ловкий
3) говоря про человека, умеющий лекго убеждать людей в чем-то, будучи неискренним; хитрый
4) говоря про поверхность, гладкая, мокрая и скользкая
5) говоря про поверхность, гладкая и блестящая

a slick - пятно нефти, плавающее на поверхности моря или озера в результате случайного разлива из судна или контейнера

to wheeze - хрипеть

a poultice - мягкая влажная масса, часто нагретая и лечебная, которая наносится на кожу для уменьшения воспаления, облегчения боли, ускорения заживления или иного лечения ран или недугов; припарка

a fornication - половой акт с человеком, с которым вы не состоите в браке; прелююодияние, блуд

an ambidexterity - амбидекстрия

an endive - эндивий

a sigil - сигил, сигилла

a luminary -  эксперт в определенной области или деятельности; светила

a denizen of a place - человек, животное или растение, которое живет или растет в этом месте; обитатель