covert - скрытый или секретный, тайны; открыто не признанный

spacefaring - имеющие транспортные средства, способные путешествовать за пределы земной атмосферы

a thruster - двигатель (например, реактивный двигатель), который развивает тягу за счет выброса струи жидкости или потока частиц

a buoy - буй

a fatigue - усталость, утомление или истощение от работы, физической нагрузки, напряжения или стресса

to dissipate - постепенно исчезать и растрачиваться; рассеиваться

to excel - быть чрезвычайно хорошим в чем-то; превосходить

to tint + a color - слегка окраситься в какой-то цвет

for the betterment of someone or something - ради улучшения кого-то или чего-то

to cultivate something - опытаться что-то развить и улучшить

intrinsic - принадлежащий к неотъемлемой природе или сущности чего-то или кого-то; присущий, неотъемлемый

a spoke - спица в колесе

an angle of depression - угол, образованный горизонтальной линией и линией, соединяющей объект и глаз наблюдателя

an elevation - градус наведения орудия над горизонтом

a cargo hold - грузовой отсек

on the fringe(s) of something - на краю чего-то

Attican Traverse - Аттический Траверс

to raze something - полностью уничтожить, например, город или здание; снести, сравнять с землей

to lay siege to something - говоря про полицию, солдат или журналистов, окружать какое-то место, чтобы заставить людей выйти или отказаться от контроля над этим местом; осаждать

to perish - умереть, особенно в результате несчастного случая или будучи убитым, или быть уничтоженным; погибнуть

a prospector - человек, который ищет золото, нефть или другие ценные вещества на поверхности земли или под ней; старатель

downwind - двигающийся, куда движется ветер

a thresher - 1) человек или машина, отделяющая зерно от растений путем отбивания; молотилка, молотильщик 
2) акула, живущая на поверхности, с длинной верхней долей хвоста, часто охотятся парами, хлеща хвостом по воде, чтобы собрать рыбу в плотную стаю; молотилка, молотильщик

a maw - пасть

to devour something - съесть что-нибудь жадно и в больших количествах, чтобы ничего не осталось; пожирать

in retaliation for something - в отместку за что-то

an animosity - сильная неприязнь, противостояние или гнев; враждебность, неприязнь, вражда

supranational -включающий участие более чем одной страны или имеющий власть или полномочия, превышающие полномочия отдельных стран; наднациональный, надгосударственный

piecemeal - характеризующийся бессистемными частичными мерами, принимаемыми в течение определенного периода времени

jointly - совместно, сообща

to dither - быть не в состоянии принять решение о том, чтобы сделать что-то; колебаться

to bicker about/over something - спорить о вещах, которые не важны

a debriefing - разбор полетов

under false pretenses - под ложным предлогом

a shakedown run - акт испытаний новой единицы оборудования, в частности транспортного средства

an infirmary - комната в школе, колледже или университете, где учащиеся, получившие травму или плохо себя чувствующие, могут обратиться к медсестре для лечения; лазарет

a picket - отдельный отряд солдат, служащий для охраны армии от неожиданностей

an envelope - что-то, что обволакиваетж; обертка, оболочка

a Doppler effect - изменение, которое кто-то испытывает в частоте волн, например звука или света, когда изменяется расстояние между этим человеком и источником волн

to deem - рассматривать или судить о чем-либо определенным образом

backroom - совершено тайно или не привлекая внимания

contentious - вызывающий, вовлекающий или способный вызвать разногласия и споры; спорный, противоречивый

the bulk of something - большинство чего-то

to evict someone from somewhere - заставить кого-то уйти откуда-то; выселить

a truce - кратковременный перерыв в войне или споре, или соглашение прекратить борьбу или спор в течение определенного периода времени; передышка

a filament - 1) тонкий нитевидный объект или волокно, особенно в структурах животных или растений; нить 
2) тонкий провод, особенно такой, который загорается внутри электрической лампочки

a distress call - сигнал в органы власти, уведомляющий их о человеке, транспортном средстве или судне, требующем экстренной помощи; сигнал о помощи

to unearth something - обнаружить что-то в земле; раскопать

to fare - достигать какой-то степени успеха в конкретной ситуации или деятельности; поживать, справляться (например, хорошо или плохо)

miniscule / minuscule - очень маленький; крошечный, крохотный

a ridge - длинная узкая возвышенная часть поверхности, особенно высокий край горы; хребет

a ramp - 1) искусственный склон; пандус 
2) приподнятая полоса, встроенная в дорогу, чтобы автомобили двигались медленнее

to have/keep someone's guard up - быть осторожным и бдительным

unsettled - 1) нервный и беспокойный; не в силах расслабиться
2) говоря про территории, незаселенный

a shriek - короткий, громкий, высокий крик, особенно тот, который произносится внезапно как выражение сильного чувства; визг, пронзительный крик

a smuggling ring - группа лиц, причастных к тайному и незаконному ввозу или вывозу запрещенных или облагаемых пошлиной товаров; сеть контрабандистов

to hold out on someone - отказаться от предоставления помощи или информации кому-либо; утаить что-то от кого-то

to bore - сделать отверстие в чем-то с помощью инструмента; просверлить, пробурить

a forty winks - короткий сон днем

ablative - относящийся к абляции или подлежащий абляции путем плавления или испарения; абляционный

sealable - способный к запечатыванию или быть запечатанным; пломбируемый

an affiliation - состояние или отношение тесной связи или принадлежности к определенному лицу, группе, партии, компании и так далее

to adhere to something - обязывать себя к соблюдению, например, каких-то правил

to be fraught with something - быть полным чего-то плохого или нежелательного

disparate - во всем разный; разрозненный, несовместимый, в корне отличный

paleotechnic - относящийся к или составляющий период промышленного развития, отмеченный преобладанием ручных инструментов и ремесленных производств или сложных производств, основанных на использовании угля и железа

to pick something clean - удалить весь материал, который покрывает что-либо; обглодать

derelict - говоря про здания, заброшенный

to meddle in/with something - пытаться изменить или повлиять на вещи, которые не входят в вашу ответственность, особенно путем критики в разрушительной или раздражающей манере

misremembered - запомненные неправильно

to round something/someone up - найти и собрать группу животных или людей

withered - сухой и разлагающийся; увядающий

a husk - шелуха, оболочка

a trace minerals - микроэлементы ???

to spring up - внезапно начать существовать

a shore leave - время, когда моряк не работает на корабле и может проводить время на суше

to drop the ball - совершить ошибку, особенно не предпринимая действий или не занимаясь чем-то, что должно было быть запланировано

in someone's books - по чьему-то собственному убеждению или мнению, особенно когда оно отличается от убеждений или мнений других людей

a prerogative - прерогатива

to let something/someone slide - ничего не делать с чем-то или кем-то, когда вы должны попытаться изменить или исправить что-то или кого-то

a revolution - вращение

a proceeding - разбирательство, производство (например, в суде)

a containment - акт контроля или ограничения чего-то или кого-то вредного; сдерживание

vehicular - имеющий отношение к транспортному средству; автомобильный

a pressure suit - надувной костюм для высотного или космического полета для защиты тела от низкого давления; скафандр

derisive - проявляющий насмешку

a daisy chain - схема подключения, в которой несколько устройств соединены вместе последовательно или по кольцу

far-reaching - имеющий большое влияние на многих людей или вещи; далеко идущий

impregnable - говоря про укрепленную позицию, невозможный для захвата или взлома; неприступный

enigmatic - таинственный и невозможный для полного понимания; загадочный

coaxial - коаксиальный

a planetoid - астероид

to extricate - удалить что-то или освободить что-то с трудом; извлечь, выпутать

to impel something - придавать движение чему-то

in-utero - в утробе

to coalesce into something - говоря про две или более вещей, сливаться воедино, объединяться или срастаться, чтобы образовать одну вещь или систему чего-то

prominently - в значительной степени; занимая видное место

a supernova - сверхновая

a neutron star - нейтронная звезда

a pulsar - пульсар

a telepresence - использование различных технологий для создания эффекта нахождения в другом или воображаемом месте, либо для управления оборудованием из другого места; телеприсутствие

sturdy - физически сильный и твердый или толстый, и поэтому вряд ли может сломаться или пораниться; крепкий, прочный

to fabricate - производить продукт, особенно в промышленном процессе

touchy - легко обижаемый; обидчивый

an outrage - шокирующее, морально неприемлемое и обычно насильственное действие

a clearance - официальное разрешение на что-либо или состояние выполнения официальных условий чего-либо; разрешение, допуск

to jeopardize something - поставить что-то под угрозу провала или порчи

to defy - отказаться подчиняться или делать что-то обычным или ожидаемым образом; нарушить, бросить вызов

a compromise - компромисс

a mediator - человек, чья работа заключается в урегулировании разногласий; примиритель, посредник, медиатор

an accord - официальное соглашение

a consort - жена или муж, особенно правителя; консорт, спутница, супруга

suffice (it) to say, ... - достаточно сказать, что ...

strained - натянутый (например, приветствие или отношения)

remorseful - полный расскаяния или сожаления

a confines of something - в пределах границ окружающих чего-то

tight-knit - тесно связанный; сплоченный

to chastise - резко критиковать кого-либо

a rebuke - акт гневного разговора с кем-то, потому что вы не одобряете то, что они сказали или сделали; упрек, выговор

a malcontent - человек, который не удовлетворен тем, как обстоят дела, много жалуется, неразумен и с ним трудно иметь дело; недовольный

misconceived - плохо спланированный из-за непонимания ситуации и, следовательно, не подходящий или вряд ли успешный; имеющий неправильное представление

malleable - легко поддающийся влиянию или контролю со стороны других людей; податливый

cranky - легко раздражаемый

a concession - уступка

to have a chip on your shoulder - все время выглядить злым, потому что считать, что с вами обошлись несправедливо, или чувствовать, что вы не так хороши, как другие люди

preferential - более лучший, чем то, что дано другим; льготный, преференциальный

extraterritorial - за пределами (законов) страны; экстерриториальный

a ward - одна из областей, на которые разделен город или поселок, имеющая своего собственного избранного политического представителя или свои собственные организации для управления услугами;
административный район

a plight - неприятное состояние, особенно серьезное, печальное или тяжелое; положение

warranted - получивший официальные полномочия сделать что-либо или сделанный с официального разрешения

underhanded - сделанный тайно, а иногда и нечестно, с целью добиться преимущества; закулисный

to bend the rules - нарушать правила способом, который вы считаете неважным или не вредным; немного отклониться от правил

to liaise - разговаривать с людьми в других организациях и тому подобное, чтобы работать с ними или обмениваться с ними информацией; поддерживать связь

contented - удовлетворенный своей жизнью или ситуацией, в которой находится; довольный, удовлетворенный

to attend to someone - помогать или заботиться о ком-то, кто ранен или болеет

to soothe someone - заставить кого-то чувствовать себя спокойно или меньше волноваться; успокоить, утешить

a clientele - клиентура

a motion - официальное предложение, сделанное, обсужденное и принятое на собрании

to quash - официально заявить, что что-то, особенно более раннее официальное решение, более не принимается; отменить, аннулировать

to swell - стать крупнее и круглее, чем обычно; вызывать увеличение размера или количества; набухать, разбухать, раздуваться, нарастать

to procure something - получить что-то, особенно после приложения усилия; раздобыть

inquisitive - любознательный

an intimate - друг, которого вы хорошо знаете; близкий друг

to keep tabs on someone or something - внимательно наблюдать за кем-то или чем-то, чтобы узнать, что делает этот человек или вещь

shady - нечестный или незаконный; сомнительный (например, сделка)

undisclosed - говоря про информация, секретный; неразглашенный

a splendor - великолепная красота, привлекающая восхищение и внимание; великолепие

a testament to something - доказательство чего-то; свидетельство

a hum - гул

an incarceration - заключение в тюрьму
	
a coat-tails - длинные, разделенные куски ткани, которые свисают со спины старомодного формального мужского пиджака

compelling - 1) говоря про аргумент и тому подобное, убедительный, заставляюющий вас поверить в это или принять это
2) очень увлекательный и интересный, заставляющий хочется смотреть или слушать; захватывающий

reckless - делающий что-то опасное и небеспокоящийся о рисках и возможных результатах; безрассудный

to disbar someone for something - лишить кого-либо права работать адвокатом, особенно потому, что он сделал что-то неправильное или незаконное

to turn up something - обнаружить что-то, особенно неожиданно

dingy - темный и часто еще и грязный (например, клуб или корридор)

a one-way street - говоря про соглашение или отношения, иметь в виду, что только одна из сторон соглашения или отношений что-то предлагает или получает от этого выгоду

to jump through hoops - иметь необходимость делать много вещей, которые кажутся трудными или ненужными, чтобы чего-то добиться

to be up in the air - не иметь принятого решение по чему-то; быть в подвешенном состоянии

a loophole - возможность юридически избежать неприятной ответственности, обычно из-за ошибки в написании правил или законов; лазейка в законе

coy - намеренно держащий что-то в секрете

to exact something - требовать и получать что-либо, иногда применяя силу или угрозы; взыскать, вымогать

an abrogation - акт официального прекращения действия закона, соглашения или обычая; расторжение, аннулирование

a forfeiture of something - потеря прав, имущества или денег, особенно в результате нарушения юридического соглашения; конфискация, потеря

to assuage someone - сделать чьи-то неприятные чувства менее сильными

to hail from somewher - быть родом откуда-то

to litter - быть разбросанным по какой-то территории или размещеным неаккуратно; валяться

to spite someone - намеренно раздражать, расстраивать или причинять кому-либо вред; делать назло кому-то

to exonerate someone from something - показать или заявить, что кто-то или что-то в чем-то не виновно в чем-то

hush-hush - держащийся в тайне от людей

to brown-nose - добиваться благосклонности от кого-то подобострастно

a sermon - длинный разговор, в котором кто-то советует другим людям, как они должны вести себя, чтобы стать лучше; проповедь, поучение

to bring someone down - привести к тому, чтобы кто-то, наделенный властью, потерял работу

to shell something out for something - платить или давать деньги за что-либо, как правило, неохотно; выложить

dismayed - чувствующий себя несчастно и разочарованно; встревоженный

assuredly - конечно, несомненно

to incur something - испытать что-то, обычно неприятное, в результате действий, которые вы предприняли; влезать (например, в долги), навлечь на себя, подвергаться, вызвать на себя (например, гнев)

an affirmation - утверждение или знак того, что что-то является правдой; подтверждение

astute - способный быстро понять ситуацию и увидеть, как извлечь из нее выгоду; проницательный

to tip the balance/scales in favour of someone - менять баланс в чью-то пользу или склонять чашу весов в чью-то пользу

on the house - за счет заведения

a fuss - демонстрация гнева, беспокойства или волнения, которые не нужны или больше, чем того заслуживает ситуация; суета или шумиха по поводу чего-то

to disseminate something - распространять или раздавать что-либо, особенно новости, информацию, идеи и так далее, большому количеству людей; распространять

deferred - отложеный на более позднее время

to funnel something - говоря про деньги, товары или информацию, переправлять из одного места в другое по мере появления денег, товаров или информации

ascertain something - выяснить что-то; установить, выяснить

to be on edge - нервничать или волноваться; быть на взводе

an intrusion - случай, когда кто-то попадает в место или ситуацию, где он не нужен или не ожидается; вторжение, вмешательство

to maul someone - напасть на кого-то агрессивно и часто каким-то образом причинить ему вред

to mangle someone or something - разрушить что-либо, скрутив это с силой или разорвав на куски так, чтобы первоначальная форма полностью изменилась; искалечить

to flinch from something - не хотеть что-то делать или думать об этом, либо избегать этого; дрогнуть перед личом чего-то, уклоняться от чего

irrefutable - неопровержимый

to be revered for something - почитатья за что-то

formidable - вызывающий страх или уважение, потому что очень могущественный или сильный; грозный, внушительный (например, соперник)

a self-reliance - качество отсутствия потребности в помощи или поддержке со стороны других людей; уверенность в себе

to stonewall - препятствовать тому, чтобы кто-то получил информацию, не будучи полезным или отказываясь отвечать на вопросы

to hold someone's breath - тревожно или взволнованно ожидать, что что-то произойдет; затаить дыхание

a privateer - человек или корабль, которому правительство разрешило атаковать и воровать корабли в море, особенно в 17 и 18 веках; капер

snobbish - снобистский

a middleman - посредник

to cut someone loose - отпустить или освободить кого-то от чего-то, например, от положения, отношений или обязательств

to give somebody an edge - давать кому-то преимущество

to put someone in a bind / in a box / in a hole / in a jam / in a tight corner / in a tight spot - поставить кого-то в безвыходное, неловкое или трудное положение

to see oneself out - покинуть место (например, здание или закрытую территорию), не доводя человек до места выхода (например, до двери или ворот)

to commemorate - официально помнить и отдавать дань уважения великому человеку или событию, особенно публичной церемонией или созданием статуи или здания; почтить память

uplifted - 1) говоря про лица или руки людей, приподнятые, указывающие вверх
2) говоря про настроение, приподнятое

to scour something - очень тщательно обыскивать место или вещь, чтобы попытаться что-то найти; рыскать, прочесывать

a sighting - случай, когда вы видите что-то или кого-то, особенно что-то редкое или пытающееся скрыться; наблюдение

a fumes - неприятный и часто вредный для здоровья дым и газы, образующиеся в результате пожаров или таких вещей, как химикаты, топливо или приготовление пищи; дым, пары, выхлопы

to keep something under wraps - хранить что-то в секрете или тайне

a foul play - преступное деяние, повлекшее причинение серьезного ущерба или телесных повреждений, особенно убийство

stiff - твердый или крепкий, легко не сгибающейся; жесткий

a helmsman - человек, управляющий кораблем или лодкой с помощью ручки или штурвала; рулевой, кормчий

brittle - тонкий и легко ломающийся; хрупкий

a crutch - костыль

creaky - скрипучий

a knack for/of/to something - умение или способность делать что-либо легко и хорошо

to give someone away - раскрывать кого-то; выдавать

a dreadnought - линкор, вооруженный тяжелыми орудиями одинакового калибра; дредноут

a cast-offs - вещи, обычно одежда, которые вам больше не нужны; обноски

to refit something - привести корабль или здание и так далее, в хорошее состояние, отремонтировав его или добавив новые детали; переоборудовать, переоснастить

to repeal something - говоря про правительство, отменить закон, чтобы этот закон больше не имел юридической силы

to skirt the rules - избегать правил, не нарушая их

to skirt the bounds of the law - выходить за рамки закона ???

in concert with someone or something - вместе с кем-то или чем-то

an overseer - надзиратель, надсмотрщик

(it) serve someone right - фраза, чтобы сказать, что кто-то заслуживает что-то плохое за свое поведение

a rite of passage - официальная церемония или неформальное мероприятие, знаменующее важный этап или событие в жизни человека, особенно взросление; ритуал или обряд перехода

a stigma to something - сильное чувство неодобрения, которое большинство людей в обществе испытывают по поводу чего-либо, особенно когда это несправедливо; клеймо

a stillbirth - мертворождение

to saddle something (up) - оседлать что-то

to dwell on something - думаеть, говорить или писать о чем-то, особенно на неприятном, много или довольно долго; зацикливаться на чем-то

a parthenogenesis - партеногенез

to attune something to something - настраивать что-то, чтобы что-то понять или распознать (например, настроить свои уши на прослушивание лекции)

unseemly - не соответствующий установленным стандартам хорошего тона, поведения или вкуса; неподабающий

a promiscuity - беспорядочное сексуальное поведение; распущенность

to meld with something - слиться с чем-то

a councilor - советник

dull-witted - медленный, чтобы понять или учиться; не очень умный; тупой

to let on - рассказывать другим людям о чем-то, что вам известно, особенно если это секрет

to plunge someone or something into something - внезапно испытать плохую ситуацию или несчастье, или заставить кого-то или что-то внезапно испытать плохую ситуацию или несчастье; окунуть, погрузить (например, страна погрузилась в хаос)

futile - говоря про действия, не имеющие никакого эффекта или ничего не достигающие; бесполезный, пустой, тщетный

a dismay - чувство несчастья и разочарования

much to the dismay of someone - к большому несчастью для кого-то

to instigate something - заставить событие или ситуацию случиться, запустив череду действий или формальный процесс; спровоцировать, инициировать

a staging base - промежуточная база

someone-backed or something-backed - получающий от кого-то или от чего-то поддержку, особенно финансовую

in the aftermath - в результате или в последствии после какого-то неприятного события или несчастного случая

restless - не желающий или не в состоянии оставаться на месте или быть тихим и спокойным, потому что обеспокоен или скучает; беспокойный, неугамонный

deliberate - медленный и неторопливый, как будто дающий время для принятия решения о каждом отдельном действии

ponderous - говоря про книги, речь или стиль письма или устной речи, скучный, потому что слишком медленный, длинный или серьезный; тяжеловесный

to subvocalize - формировать слова молча, двигая губами или другими голосовыми органами без вокализации

a subtlety - утонченность, тонкость

to uplift someone or something - поднять кого-то или что-то на более высокую позицию

to harbor something - думать или чувствовать что-то, обычно в течение длительного периода времени; питать, затаить (например, обиду)

a pilgrimage - паломничество

a prowess - выдающаяся способность или навык; мастерство

a greenhouse - парник

an ammonia - аммиак

to incline someone to/towards something - заставить кого-то почувствовать что-то или захотеть что-то сделать; склонять

to author something - создать что-то; быть автором чего-то

otherwise - иным образом

an expanse of something - большой открытый участок земли, воды или неба; простор

to pick over something - внимательно посмотреть на группу вещей, выбрав нужные или избавившись от ненужных; тщательно перебрать

sizable / sizeable - большой; значительный

a pole - 1) столб (например, фонарный)
2) полюс

decaying - постепенно повреждающийся, ухудшающийся или уменьшающийся; разлагающийся, распадающийся

to be tapped by something - быть подключеннымк чему-то (например, к трубе или канализации)

an aqueduct - акведук

an antiquity - далекое прошлое, особенно до шестого века; древность, древние времена

to congest something - заблокировать или переполнить что-то собой таким образом, чтобы это вызывало трудности; загромождать, перегружать, переполнять

a glacier - ледник

chartered - говоря про компании, колледжи, города или другие органы, учрежденный или имеющей свои права и привилегии, установленные посредством устава; зарегестрированный

a hot lab - лаборатория, предназначенная для работы с радиоактивными веществами

exempt from something - имеющий специальное разрешение ничего не делать и не платить; освобожденный от чего-то (например, от уплаты налогов)

to survey something - измерить площадь территори и записать ее детали, особенно на карту

desperate - отчаянно нуждающийся в чем-то

in the wake of something - происходящий вслед за чем-то другим и часто именно из-за этого

a land grab - акт захвата территории силой по военным или экономическим причинам; захват земли

untapped - говоря про запас чего-то ценного, еще неиспользуемый или нетронутый

negligible - незначительный, не принимаемый в расчет

relativistic - релятивистский

a time dilation - замедление времени

a fusion torch - техника использования высокотемпературной плазмы термоядерного реактора для разделения других материалов (особенно отходов) и преобразования их в несколько повторно используемых и пригодных для продажи элементов; термоядерная горелка

a motive power - энергия (в виде пара, электричества и так далее), используемая для привода механизмов в движение

prohibitively - больше, чем большинство людей в состоянии заплатить; непомерно дорого, чрезмерно много

to screen someone or something - защитить или скрыть кого-то; прикрывать

a cautionary tale - история, которая дает предупреждение; поучительная история

an advocacy - общественная поддержка идеи, плана или способа сделать что-либо; защита прав, правозащитная деятельность

a sentience - 1) состояние или качество сознания; осознание, разум
2) качество быть способным испытывать чувства

to collate something - объединить различные фрагменты информации, чтобы можно было увидеть сходства и различия; сопостовлять

a feat - действие, демонстрирующее мастерство, силу или храбрость; подвиг, достижение

a spiral arm of a galaxy - спиральный рукав галактики

omnidirectional - всенаправленный

an attraction - притяжение (например, гравитационное)

a repulsion - отталкивание (например, магнитное)

unattainable - недостижимый

a chip of something - небольшой кусочек чего-либо или маленький кусочек, отколотый от чего-либо

to suspend something - подвесить что-то

medicinal - лекарственный, лечебный

a salve - мазь

a clotting agent - коагулянт

to shear off something - срезать что-то

a gale - очень сильный ветер; шторм, буря

timely - своевременный

a standstill - состояние, при котором все движения или деятельность прекращается
	
to fight someone to a standstill - бороться или воевать с кем-либо до упора

foolproof - говоря про план, метод или машину, предназначенный для легкого выполнения или эксплуатации без возможности ошибки или отказа; надежный

to spin something off - производить полезный и неожиданный результат в дополнение к предполагаемому результату; порождать

hereditary - наследственный

a deterrent - сдерживающий фактор

to carry/bring (someone) to term - вынашивать беременность

a viability - способность продолжать существовать или развиваться как живое существо; жизнеспособность

to leverage something - использовать то, что у вас уже есть, чтобы достичь чего-то нового или лучшего

to seize something - взять или захватить что-то внезапной силой

a withdrawal - вывод войск

to dare someone to do something - попросить кого-то сделать что-то, что сопряжено с риском

crippling - оказывающий на политику или ситуацию разрушительное очень серьезный, вредный эффект; сокруштельный, разрушительный

blue-white - говоря про алмазы, бесцветный и самого высокого качества

a freighter - грузовое судно

prompt - говоря про действиях, совершенное быстро и без промедления, или говоря о человеке, действующий быстро или прибывающий в назначенное время; незамедлительный

first and foremost - больше, чем что-либо; в первую очередь

a weariness - состояние скуки от чего-то, потому что вы слишком много испытали этого; усталость

to stiffen someone or something - сделать кого-то или что-то сильнее или сложнее; укрепить, ужесточить

an unrest - разногласие или борьба между различными группами людей; беспорядок (например, общественный), волнение

a holdout - человек, организация или страна, которые продолжают что-то делать, несмотря на то, что другие люди пытаются заставить их не делать этого; несогласный

an insurgent - кто-то, кто борется против правительства в своей стране; повстанец

frontier - пограничный

perpetual - продолжающийся вечно в том же духе; вечный

a cracking - процесс, при котором большие молекулы углеводорода расщепляются на более мелкие молекулы; крекинг

space-intensive - занимающий много места; объемный

a surplus - избыток излишек

siliceous - содержащий кремний

cometary - кометный

a locust - саранча

rarefied - 1) настолько стильный, умный или нравственный, что кажется возвышенным над обыденностью; утонченный
2) высокого качества, утонченный (например, навыки чего-то) ???

precarious - в опасном состоянии из-за небезопасности или ненадежного удержания на месте; ненадежный

legislative - законодательный

an outrider - человек, особенно полицейский, который едет на мотоцикле рядом или перед служебным транспортным средством

to defer someone or something - позволять кому-то или чему-то принимать решения за вас или указывать вам, что делать, из-за вашего уважения к ним или из-за их более высокого ранга, авторитета, знаний и так далее; подчиняться

summarily - вдруг, без обсуждения и судебного процесса; в срочном порядке, без суда и следствия

to overturn something - говоря про законные решения, отменить

to pool something - собирать что-то, например, деньги, чтобы их могли использовать несколько разных людей или групп

a dismissal - акт об официальном увольнении работника с работы; уволнение

to sprawl - покрыть большую площадь, особенно постепенно в течение определенного периода времени; располстизь, раскинуться

motley - состоящий из множества разных типов, которые, кажется, не сочетаются друг с другом; пестрый, разношерстный

an aggregation of something - процесс объединения вещей в единую группу; агрегация, скопление

spaceworthy - подходящй для запуска или путешествия в космос

dedicated - предназначеный для использования с одной конкретной целью; специализированный, выделенный, специальный

a cabin - отдельное помещение в воздушном судне для пассажиров или обслуживающего его персонала, либо помещение на судне, оборудованное спальными местами; салон, каюта

a cubicle - очень маленькое закрытое помещение, например, где можно принять душ или переодеться; кабинка

to enliven something - сделать что-то более интересным или активным; оживить, разнообразить

austere - очень простой, имеющий только то, что необходимо, особенно из-за жестких ограничений на деньги или товары; строгий, суровый (например, квартира)

a quilt - одеяло

a tapestry - гобелен

to muffle something - говоря про звук, заглушить

prospective - возможный; предпологаемый, потенциальный (например, покупатель)

shoestring - говоря про бюджет или ресурсы, скудный

Stripped of something, ... - Если не принимать во внимание что-то, ... ???

an inbreeding - инбридинг, близкородственное размножение

a stockpile of something - большое количество еды, товаров или оружия, которые хранятся наготове для будущего использования; запасы чего-то

an impactor - объект (например, метеорит), который сталкивается с другим телом

an accretion of something - постепенное увеличение или рост чего-то за счет добавления новых слоев или частей; аккреция, присоединение, наслоение

a warhead - передняя часть бомбы или ракеты, содержащая взрывчатое вещество; боеголовка

deliberately - намеренно

a tampering - действие по прикосновению или изменению чего-то, чего вы не должны делать, обычно, когда вы пытаетесь повредить это или сделать что-то незаконное; вмешательство, несанкционированный доступ

to bear fruit - давать успешные результаты; приносить плоды

to answer to someone - получать приказы, подчиняться и объяснять свои действия кому-либо

a customs enforcement - таможенный контроль

a search-and-rescue - поисково-спасательные работы

to puzzle something out - обнаружить или понять что-то, тщательно обдумав это; разгадать, распутать

a perpetrator - лицо, совершившее преступление или насильственное или вредоносное действие; преступник

a special response - отдел специального реагирования

to be at odds with someone or something - быть в несогласии с кем-то или чем-то; быть в ссоре; расходиться

to lend credence to something - сделать что-то более правдоподобным или вероятным, возможно, предоставив дополнительную информацию или подробности; подтвердить что-то

..., in turn, ... - ..., в свою очередь, ...

to aggravate someone - раздражать кого-то

a due process - надлежащая правовая процедура

to hamper something - помешать кому-то сделать что-то легко; препятстовать, мешать

a bustle - занятая деятельность; суета

ubiquitous - вездесущий, повсеместный

to apprehend someone - поймать и арестовать того, кто не соблюдал закон; задержать

a nebula - облако газа или пыли в космосе, кажущееся либо ярким, либо темным; туманность

prevailing - преобладающий, господствующий

to hold - верить в какую-то идею или мнение; считать (например, считать, что кто-то отвественный за что-то)

to render something down to something - расщеплять что-то на что-то

a sandblaster - пескоструйный аппарат

unadvisable/inadvisable - неразумный и может привести к нежелательным результатам, поэтому стоит избегать; нецелесообразный

an enclave - часть территории внутри или вокруг большей территории, жители которой отличаются культурно или этнически; анклав

akin to someone or something - имеющий некоторые из тех же качеств, что и у кого-то или чего-то; похожий

a superstructure - говоря про здания, надземная часть; надстройка

to be sealed against something - быть герметичным, чтобы бы быть защищенным от чего-то

a membrane - мембрана

a sulphur hexafluoride - гексафторид серы

inexplicable - невозможный для объяснения или понимания; необъяснимый

a mistrust of someone or something - недоверие

rife - говоря про что-то неприятное, очень распространенное или случающееся часто

As a practical matter, ... - Но на практике, ...

simmering - контролируемый, но может взорваться или перейти в более экстремальное состояние в любой момент; кипящий

to know better than to do something - быть достаточно мудрым, чтобы не делать что-то; знать, что нельзя что-то делать

unconditionally - безоговорочно

to live down something - заставить людей забыть то, что вы совершили большую ошибку или сделали что-то очень постыдное в прошлом

to prosecute something - продолжать принимать участие в запланированной группе мероприятий, особенно в войне; продолжать, вести

a rank-and-file - солдат, не являющийся офицером, или член организации, не входящий в руководство; рядовой

a squadron - оперативное подразделение военно-воздушных сил, состоящее из двух или более звеньев самолетов и личного состава, необходимого для их управления; эскадра, эскадрилья, эскадрон

a fighter squadron - истребительная эскадрилья ???

a futility - говоря про действия, не имеющий никакого эффекта или ничего не достигающий; тщетность, бесполезность

a serviceman - военнослужащий

a rear admiral - офицер ВМС США или береговой охраны в ранге выше коммодора и ниже вице-адмирала

vocational - говоря про подготовку и навыки, необходимый для конкретной работы или профессии; профессиональный (например, профессиональная подготовка в области инженерии)

a proficiency - факт наличия навыков и опыта для выполнения чего-либо; уровень владения чем-то, опыт, мастерство

a pane of glass - плоский лист стекла в окне или двери; оконное стекло

an accretion disk - аккреционный диск

a quasar - квазар

a crew consideration - размещение команды ???

a hot bunking / a hot racking - обычная практика (часто встречающаяся на борту военно-морских подводных лодок), когда несколько человек спят в одной постели

o hole something - продырявить что-либо, особенно корабль или лодку

a bubble - пузырек, баллон ???

a bow - нос корабля

laterally - латерально, сбоку

a point of reference for something - информация или опыт, которые у вас уже есть, которые помогут вам понять или справиться с новой ситуацией; отправная точка для чего-то, ориентир для чего-то, точка отсчета

to show the flag - говоря про военно-морской корабль или вооруженные силы, идентифицировать себя, демонстрируя флаг страны своего происхождения, особенно для того, чтобы установить авторитетное присутствие и оказать дипломатическое или политическое влияние

a broadside - 1) борт
2) одновременная стрельба из всех орудий с одного борта военного корабля; бортовой залп

commensurate - соразмерный

TNT / trinitrotoluene - тринитротолуол

a ission weapon/bomb - ядерное оружие, в котором огромная энергия высвобождается при делении ядер (расщеплении ядер тяжелых элементов, таких как уран-235 или плутоний-239)

a re-entry - момент возвращения космического корабля в атмосферу Земли после пребывания в космосе

a friction - трение, сила трения

to sap someone or something - сделать кого-то слабее или отнять у кого-то силу, особенно за длительный период времени; поглотить, подрывать, подтачивать

an assembly - структура, полученная в результате какого-то процесса; сборка

to press something home - повторять или объяснить что-то тщательно, чтобы быть уверенным, что кто-то полностью это поймет

to cripple something - нанести серьезный ущерб чему-либо, так что оно не cможет работать эффективно; покалечить

to make short work of something - покончить или разобраться с чем-либо быстро; быстро расправиться

handily - удобно, ловко

to circle-strafe - двигаться вокруг цели по кругу, стоя лицом к ней, чтобы избегать контратак при атаке с близкого расстояния

a bandwidth - пропускная способность

to parcel something out on something - разделить что-то и раздать отдельные части разным людям

a buildup - увеличение числа или количества чего-то; наращивание, накопление, сосредоточение

a gross weight - вес брутто

cursory - беглый, поверхностный (например, взгляд)

an argon - аргон

a chlorine - хлор

a sodium - натрий

to account for something - объяснить причину чего-то

year-round - в течение всего года; весь год

equatorial - экваториальный

a crust - корка (например, хлеба)

full-featured / fully-featured - имеющий полный набор возможностей или функций; полнофункциональный, полноцнный

a stopover - краткое пребывание в каком-то месте, которое совершается во время нахождения в каком-то более длительном путешествии; остановка

to haul something - перевозить что-либо, обычно автомобильным транспортом

a deuterium - дейтерий

terrestrial - имеющй отношение к Земле или похожий на нее; земной

a krypton - криптон

a xenon - ксенон

a silica - кремнезем

a flyby - полет, особенно на космическом корабле, мимо определенной точки в космосе; пролет

a protrusion - что-то, что торчит из поверхности, или действие, описывающие процесс, которого что-то торчит из поверхности; выступ, выпячивание, высовывание

elaborate - содержащие много тщательных деталей или много подробных частей

sacrosanct - считающийся слишком важным или слишком особенным для изменения; священный; неприкосновенный

to tie something up - привести к тому, что что-то, часто деньги или имущество, не будет доступно для использования

a methane - метан

a hydrocarbon - углеводород

frigid - говоря о погодных условиях или условиях в помещении, очень холодно

a slush - снег, который лежит на земле и начал таять; слякоть

a core sample - керн

to dot somewhere - распространяться по области или распространять множество похожих вещей по области; разбросять, усеять

scorching / scorching hot - очень горячий или жаркий; палящий, раскаленный

to strew something - раскидать вещи неаккуратно по поверхности или самому так себя разбросать; разбросать, валяться

a gravity well - область пространства вокруг небесного тела, в которой преобладает гравитационное поле тела

to tug something - тянуть что-то быстро и обычно с большой силой; тящить, тянуть, дернуть

a tidal force - приливная сила

immense - чрезвычайно большой по размеру или степени; огромный, необъятный

sedimentary - говоря про камни, сделанный из отложений, оставшихся под действием воды, льда или ветра; осадочный

igneous - говоря про камни, образовавшийся из магмы; магматический, вулканического происхождения

a highlands - горный район страны; высокогорье

abrasive - 1) грубый и недружелюбный; резкий
2) абразивный

dust-choked - наполненный пылью ???

a biodome - замкнутая экосистема, размещенная в куполообразной структуре; биокупол

a magnesium - магний

a swathe of something - длинная полоса или большой участок, особенно земли

basaltic - базальтовый

That said, ... - Тем не менее, ...

a grounding - действие, препятствующее плаванию корабля или полету самолета

aquatic - живущий, растущий или происходящий в воде или связанный с водой; водный, водяной

bereft of something - лишенный чего-то

a bounty of something - большое количество чего-то

inhospitable - негостеприимный

a patron - 1) человек или группа, которые поддерживают деятельность или организацию, особенно давая деньги; покровитель, патрон 
2) хозяин в древние времена, который освободил человека, которого он держал в рабстве, но сохранил некоторые права на этого человека; покровитель

an output of something - количество энергии, например, тепла или электричества, которое производится единицей оборудования; выходная мощность, выделение, излучение

biting + adjective - используется для описания очень холодной погоды, особенно когда она причиняет вам физическую боль; резкий, кусающий

a lode - залежь

fine - очень тонкие или состоящий из очень маленьких кусочков или каплей; тонкий

a by-product - побочный продукт

laden with something - носящий или держащий большого количества чего-то

treacherous - говоря про территорию, крайне опасный, особенно из-за плохих погодных условий; коварный, опасный

EVA / an extravehicular activity - выход в открытый космос

ti discourage someone from something - отговорить или попытаться отговорить кого-то от чего-то

to be off the charts - быть на очень высоком уровне (например, его давление высокое)

on the double - говоря про то, что кто-то делает, очень быстро или сразу

light-headed - чувствующий головокружение, слабость и как будто собирающийся потерять равновесие

an appraisal - акт изучения кого-то или чего-то, чтобы судить об их качествах, успехе или потребностях; оценка

easy on the eye/ear - приятный, чтобы смотреть или слушать

bookish - получающий удовольствие от книг больше, чем от других вещей

a bellyaching - акт жалобы; нытье

to begrudge someone someone's something - злиться, расстраиваться или завидовать из-за того, что у кого-то есть что-то, чего, по вашему мнению, он не заслуживает

outspoken - очень прямо выражающий мнение, не беспокоясь о том, что другие люди могут обидеться; прямой, откровенный

a mating - 1) акт спаривания 
2) период, в течение которого сезонно размножающееся животное способно к спариванию

a mating ritual - брачный ритуал

sapient - разумный, способный думать

mundane - очень обыденный и потому не интересный

It's/That's someone's call - используется для обозначения того, что кто-то должен принимать решение о чем-либо; это кому-то решать, это чье-то решение

to mince words - говорить расплывчато или непрямо; перемалывать слова

to be out of line - иметь неприемлемое поведение

noxious - говоря про газ или другое вещество, ядовитое или очень вредное

arid - очень сухой и без достаточного количества дождя для растений; засушливый, сухой

tantalizing - мучающий или дразнящий видом или обещанием чего-то недостижимого; соблазнительный, дразнящий

an adherent of something - человек, который решительно поддерживает конкретного человека, принцип или набор идей; приверженец, сторонник

fruitlessly - бесплодно

laced with something - загрязненый веществом (обычно вредным или токсичным), присутствующим в небольших количествах

broiling - очень жаркий или горячий; поджаривающий

a tidal locking - синхронное вращение (приливный захват)

to obscure something - сделать так, чтобы что-то не было видно или слышно; заслонить, скрыть

an orbital decay - постепенное уменьшение расстояния между двумя вращающимися телами при их максимальном сближении в течение многих орбитальных периодов

a freight - товары, но не пассажиры, которые перевозятся из одного места в другое морским, воздушным, железнодорожным или грузовым транспортом, или система перевозки этих товаров; грузы

a serpentine - серпентин

a geosynchronous orbit - геосинхронная орбита

craggy - скалистый

to scour something - удалить грязь с чего-либо, сильно потирая чем-то грубым; оттирасть, чистить

a final/last resting place - место упокоения

a nadir - точка непосредственно под определенным местом или самая низкая точка, которой достигает небесное тело, когда оно движется или кажется, что движется вокруг другого тела

to lash someone or something with something - бить с большой силой кого-то или чего-то при помощи чего-то

retrograde - движущийся в направлении, противоположном направлению движения большинства других звезд, планет и так далее

a variance - тот факт, что две или более вещи различны, или количество или число, на которое они различны; расхождение

a staging ground - место, где что-то планируется или инициируется; плацдарм

crude - сооруженный кустарным импровизированным способом; грубый, сырой

an anchorage - место, где стоит судно или может быть поставлено на якорь; якорная стоянка

a shell - основная внешняя конструкция здания или транспортного средства, особенно если внутренние части разрушены, изъяты или еще не изготовлены; обломки

a dwelling - дом или место для проживания; жилище, жилое помещение

to chip out something - отщипнуть чего-то ???

ferrous - содержащий или относящийся к железу

a cryovolcano - криовулкан

to be dubbed something by someone - получить конкретное имя кем-то, описывающее что думает этот кто-то об ком-то или о чем-то; окрестить, прозвать, назвать

a consortium - консорциум

to subside - 1) говоря про здание, землю или воду, опускаться на более низкий уровень; оседать 
2) утихать, идти на убыль

an arcology - аркология

to hollow (out) something - 1) удалить внутреннюю часть, сделать пустотелым 
2) сформировать что-то, удаляя внутреннюю часть из чего-то (например, лодки, выдолбленные из бревен)

to defy something - не поддаваться описанию или пониманию

a relief carving - рельефная резьба

wrecked - 1) очень сильно поврежденный
2) потерпевший аварию или кораблекрушение

elliptical - эллиптический

to hurl something - бросить что-то с большой силой, обычно в гневе или жестокости; швырнуть

a terminator - линия, отделяющая темную часть луны или планеты от освещенной части

a magnesia - магнезия

..., if unlikely, ... - ..., хотя и маловероятно, ...

daring - смелый и рискующий

an alga - водоросль

shallow - имеющий только небольшое расстояние от вершины до низа; мелкий, неглубокий

neglected - не получающий достаточного ухода или внимания; заброшенный

to be half again something - быть в какой-то количественной характеристике на половину меньше, чем кто-то или что-то другое

aging - являющийся или кажущийся старым; стареющий

a monoxide - монооксид

an inclusion - включение кого-то или чего-то в состав группы, списка и так далее, или человека или предмета, который включается; включение

a chart - подробная карта акватории

glancing - говоря про удар, с быстрым и легким прикосновением или ударом сбоку, а не спереди, и обычно не причиняющий большого вреда; скользящий

to tip something - двигаться или заставить двигаться так, чтобы одна сторона была выше другой стороны; опрокинуться, откинуться

a potassium - калий

a cockpit - кокпит

an emplacement of something - установка или размещение чего-то на какой-то позиции

a pipe dream - идея или план, который невозможен или маловероятен; несбыточная мечта

vibrant - 1) энергичный, захватывающий и полный энтузиазма; яркий, оживленный
2) говоря про цвет, сильно яркий

a compound - территория, окруженная забором или стеной, на которой находится группа зданий

to latch onto someone - оставаться рядом с кем-то или проводить с кем-то много времени, обычно когда они не хотят, чтобы вы были рядом; привязаться, зацепиться

to ostracize someone - преднамеренно избегать кого-то или не допускать участия кого-то в деятельности группы; подвергать остракизму

to reason with someone to do something - попытаться убедить кого-то поступить мудро или изменить свое поведение или решение, объяснив, почему это хорошая идея

to pulverize something - надавить или раздавить что-то, пока оно не превратится в порошок или мягкую массу; измельчить

jagged - грубый и неровный, с острыми концами; зубчатый

a shock zone - объем горной породы внутри или вокруг удара по земле или взрывной воронки, в которых присутствует характерный ударно-метаморфический эффект деформации или трансформации

a floodplain - участок равнины у реки, который часто затопляется, когда река становится слишком полной; пойма

a jovian planet - гигантская планета такая, как Юпитер, Сатурн, Уран, Нептун; планета юпитерианского типа

agreeable - способный быть принятым всеми; приемлимый, устраивающий всех

domed - куполообразный или покрытый куполами

allegedly - 1) используется, чтобы сказать, что было сделано что-то незаконное или неправильное, но это не было доказано; якобы, по подозрение
2) используется, когда что-то считается правдой, но не доказаной; якобы

to have the decency to do something - иметь достаточное количество приличия, чтобы сделать что-то

to flock to somewhere - двигаться или собираться в большом количестве; стекаться, валить толпами

to make for something - сделать так, чтобы что-то случилось или начало существовать, или помочь этому; привести к чему-то или сделать что-то возможным

blistering - очень горячий; палящий

anaerobic - анаэробный

cunningly - тщательно спланированным образом, особенно когда это связано с обманом других людей или созданием вещей для определенной цели; хитроумно, хитро, ловко

to lease (out) something to someone - говоря про имущество, сдавать его в аренду кому-то

to lease something - говоря про имущество, брать его в аренду

out-system - извне ???

to wrack - to wreck

a fusion plant - ядерный реактор ???

to lend someone or something something else - придавать определенное качество кому-то или чему-то

to map something - представить участок земли в виде карты

a payload - количество товаров или людей, которое транспортное средство, такое как грузовик или самолет, может перевозить

a high-level deck - верхний слой облаков

verdant - покрытый здоровыми зелеными растениями или травой; зеленый

oxygenated - насыщенный кислородом

an anaphylactic shock - анафилактический шок

In short, ... - Короче говоря, ...

favorable - положительный или приятный

an aurora - полярное сияние

a flare - внезапное увеличение яркости огня; вспышка

off-the-shelf - доступный немедленно для использование и не требующий специального изготовления для конкретной цели

AU / A.U. - astronomical unit

to wind through something - протягиваться или двигаться из одной стороны чего-то до другой стороны, между чем-то извилистым или окольным путем

to encase something - покрыть что-то полностью или заключить что-то в чем-то полностью

a molding - объект, полученный литьем

a boron - бор

a disturbance - нарушение или дезорганизация того, что ранее находилось в спокойном и упорядоченном состоянии; помехи, нарушения

a cloud band - длинное, широкое, почти сплошное образование облаков шириной обычно более одного градуса широты и длиной, по крайней мере, в четыре раза превышающей его ширину; полоса облаков

a maglev - a magnetic levitation - передовой тип транспортной системы, в которой поезд движется по магнитному пути, часто на очень высоких скоростях; магнитная левитация, маглев

to crumble something - разбить или заставить что-то разбиться на мелкие кусочки

crumbling - крошащийся, обрушивающийся

to strip something of something - 1) отнять что-то у кого-то, иногда таким образом, который кажется несправедливым или нечестным; лишить 
2) вынести все, что не является частью конструкции помещения или здания; вынести

a necropolis - некрополь

of something, something else ... - среди чего-то, что-то конкретное ...

60-odd - около или примерно 60

to blanket something in something - покрыть что-то полностью толстым слоем чего-то

a landmass - большой участок суши, такой как континент, состоящий из одного куска и не разделенный океанами; суша

a rhyolite - риолит

rabidly - экстремальным и необоснованным образом; яростно, бешено

..., if ... - ..., хотя ...

to parlay something into something - добиться успеха, эффективно используя небольшое преимущество или возможность; превратить в, обыграть в

a superheating - перегретая жидкость

a bank of something - куча или масса земли, облаков и тому подобное

an equatorial band - экваториальный пояс ???

mineralogical - минералогический

a trove of something - большое количество чего-то хорошего, полезного или ценного или место, где это можно найти; клад

heat-trapping - улавливающий или удерживающий тепло ???

a volcanic venting - вулканический выброс ???

to be (well) on someone's way to something - используется, чтобы сказать, что кто-то добился такого большого прогресса, что почти наверняка достигнит своей цели; находиться на пути к чему-то

a pressure cooker / a pressure-cooker - кастрюля с плотно прилегающей крышкой, которая позволяет быстро готовить пищу на пару под давлением; скороварка

a borax - тетраборат натрия

to oxidize - окислять или окисляться

a bulk - нечто очень большое или большое количество чего-то, не разделенное на более мелкие части

LOX - liquid oxygen - жидкий кислород

to retrofit something - говоря про машину или здание, установить в них новые детали или новое оборудование после того, как они использовались в течение некоторого времени, особенно для повышения их безопасности или улучшения их работы; модернизировать

temperate - говоря про погодные условия, ни очень жаркий, ни очень холодный; умеренный

a pleasantness - приятность

a hindrance - что-то, что мешает вам что-то делать или что-то развивать; помеха, препятствие

intermittent - непроисходящий регулярно или постоянно; останавливающийся и запускающийся неоднократно или с периодами между ними; прерывистый

a samarium - самарий

to stockpile something - хранить большой запас чего-либо на будущее; накапливать

a fertility - плодородие, плодовитость

to draw someone - привлечь внимание или заинтересовать

to tower over/above someone or something - быть очень высоким по сравнению с кем-то или чем-то другим; возвышаться над

an orchard - участок земли, на котором растут фруктовые деревья (но не апельсиновые или другие цитрусовые деревья); фруктовый сад

alkaline - щелочной

columnar - из, относящийся к, напоминающий или характеризующийся столбцами; столбчатый, колоннообразный, напечатанный столбцами

scenic - имеющий или позволяющий увидеть красивые природные особенности; живописный

to preclude something - предотвратить что-то или сделать это невозможным, или помешать кому-то сделать что-то

varied - содержащий или меняющийся между несколькими различными вещами или типами; разнообразный

a perigee - перигей

a apogee - апогей

penetrating - 1) говоря про чьи-то глаза или взгляд на кого-то или что-то, заставляющий вас думать, что знает, о чем вы думаете; проницательный
2) говоря про чей-то ум, понимающий и распознающий вещи быстро; проницательный

a ground-penetrating radar - георадар

to criss-cross - двигаться или существовать в виде линий, пересекающих что-то или друг друга; пересекаться крест на крест

a sulphur trioxide - триоксид серы

shirt-sleeves - говоря про погоду, достаточно теплый, чтобы жить или работать без куртки или пальто

to relegate someone or something to something - поставить кого-то или что-то на более низкий или менее важный ранг или положение; перевести, отвести

to teleoperate something - управлять чем-то дистанционно

a fuel cell - топливный элемент

a prospect - вероятность того, что что-то хорошее может произойти в будущем

to prospect for something - искать золото, нефть или другие ценные ресурсы на поверхности земли или под ней

to band someone or something - обвязать кого-то или чего-то чем-то

extensive - покрывающий большую площадь или имеющий большой ассортимент; обширный, широкий

trailing - образующий заднюю часть или последнюю часть чего-то

to decelerate something - уменьшить скорость, с которой движется машина

to be slated to do something / for something / - используется, чтобы сказать, что что-то запланировано случиться в определенное время или в определенной ситуации; наметить, назначить

an appropriation bill - вексель, выделяющий деньги для определенной цели; законопроект об ассигнованиях

to make nice with/to someone - приложить усилия, чтобы быть милым с кем-то, особенно для того, чтобы вы им понравились

a boondoggle - ненужная и дорогая работа, особенно оплачиваемая населением; бесполезная трата денег

to be up to snuff - быть хорошего качества, как и было запланировано, или быть приемлемого стандарта

to be on loan from/to - быть взятым в долг от кого-то или кому-то

C.I.C. - Combat Information Center

bass-ackwards - отсталым или неумелым способом; через задницу

to shake someone's head at something - помотать голов, сказав нет чему-то

a sophistry - софистика

get stuffed! - сердитый и грубый способ сказать кому-то уйти или оставить в покое

overdue - несделанный или непроизошежший, когда ожидалось или когда это было необходимо; запоздалый, просроченный, давно назревший

gratifying - доставляющий удовольствие или удовлетворени; отрадный, приятный

it is gratifying to do something - это отрадно/приятно что-то делать

defeatist - неимеющий надежды и ожидающий неудачи; пораженческий

for what it's worth - используется, когда вы даете кому-то какую-то информацию, и вы не уверены, полезна ли эта информация или важна; как бы то ни было

a bravado - демонстрация мужества, особенно когда это ненужно и опасно, чтобы заставить людей восхищаться вами; бравада

loathsome - вызывающий ненависть или отвращение

a wave-off - 1) на авианосце, сигнализирование в последнюю минуту самолету, выполняющему последний заход на посадку, что он не должен приземляться на этом конкретном проходе, а должен уйти и снова зайти 
2) отсрочка запланированной посадки, например, космического корабля, из-за плохой погоды, ожидающейся на месте приземления

full-blown - полностью разработанный, созревший или сформированный

to do someone​ or ​something justice / to do justice to someone or something - 1) обращаться с кем-то или чем-то справедливо и показывать их истинные качества; отдавать должное 
2) делать что-то как можно лучше, чтобы показать свои истинные качества и способности

liable to do something - очень вероятно, что-то сделающий

agitated - нервничающий из-за беспокойства или страха, которые трудно контролировать

a pen - небольшая территория, обнесенная забором, особенно та, на которой содержатся животные; загон

a captor - человек, захвативший человека или животное и отказывающийся их освободить; похититель

to feed someone a line - рассказать кому-то историю или объяснение чего-то, которое не соответствует действительности

to play something down - сделать что-то менее важным или менее плохим, чем оно есть на самом деле; преуменьшить

a fail-safe - устройство или мера, которая делает что-то отказоустойчивым

a skimming - действие по удалению плавающего материала с поверхности жидкости

a profusion of something - чрезвычайно большое количество чего-то; изобилие

to sink something - выкопать яму в земле или положить что-нибудь в вырытую в земле яму; выбурить

a bore - скважина, отверстие

to strike it rich - разбогатеть внезапно и неожиданно; разбогатеть

to file for bankruptcy protection - подать заявление о защите от банкротства

to disavow something - сказать, что вы ничего не знаете о чем-то, или что вы не несете ответственности или связи с чем-то; отречься, опровергнуть

a divergence of something - ситуация, в которой две вещи становятся разными или разница между ними увеличивается; расхождение (например, мнений)

steadfastly - с твердой решимостью; решительно, упорно

all the more - даже больше, чем раньше

vociferously - яростно и громко; громогласно

a likenesses of something - подобие чего-то

of note - важный, достойный упоминания или хорошо известный

a backwater - изолированное или отсталое место или состояние; заводь

to bootstrap - 1) улучшить свое положение или стать более успешным, без помощи других или без преимуществ, которые есть у других
2) начать бизнес, особенно интернет-бизнес, с небольшими деньгами

a carnivore - плотоядное животное

robust - говоря о человеке, животном или растении, сильный и здоровый

to be set upon by someone or something - быть окруженным или пойманым кем-то или чем-то, не имея возможности сбежать

to green - стать более активными в защите окружающей среды; озеленять, экологизировать

a telecommuting - деятельность, связанная с работой в компании, но пребыванием дома и общением с офисом по компьютеру и телефону; удаленная работа

to be affiliated with/beneath something - быть связаными или контролируюмыми какой-то группой или организацией

overarching - наиболее важный, поскольку включает или затрагивает все другие области; всеобъемлящий

smog-choked - имеющие загрязный воздух, например, выхлопными газами автомобилей; задыхающиеся от смога

a slum - трущоба

a long view - рассмотрение событий или обстоятельств, которые могут произойти в будущем

to take the long view - думать о последствиях, которые будет иметь эффект в будущем, а не в настоящем; смотреть на перспективу

unfazed - не сбит с толку, не взволнован и не шокирован тем, что произошло

a fruition - ситуация, когда план или идея начинают реализовываться, существовать или быть успешными; осуществление, реализация

to that/this end - как способ иметь дело с чем-то или делать что-то, о чем идет речь

an anthropologist - антрополог

quantity + strong - какого-то размера или количества

to be privy to something - получить информацию, которую не говорят многим людям

an induction - ситуация, когда кого-то официально представляют на новой работе или в организации, особенно с помощью специальной церемонии; посвящение, введение в должность

to appease someone - предотвратить дальнейшее разногласие или борьбу, позволив противоположной стороне получить то, что она хочет; успокоить

to pertain to something - быть связанным с конкретным предметом, событием или ситуацией

a inner cabinet - внутренний круг (часто неформальный) внутри кабинета (который сам может быть в свою очередь официальным внутренним кругом в правительстве или совете министров), который включает только министров (или государственных секретарей и тому подобное), наиболее близких к исполнительной главе государства, премьер-министру или чему-то эквивалентному (в частности, председательствующему) должностному лицу

incriminating - инкриминирующий

discretionary - дискреционный (например, полномочия)

to elude something - не быть пойманным кем-то; ускользнуть от кого-то

an entrepreneur - предприниматель

to embroil someone - заставить кого-то быть вовлеченным в спор или сложную ситуацию; втянуть, ввязать, втягивать

bitter - выражающий много ненависти и гнева; ожесточенный

galvanizing - стимулирующий таким образом, который провоцирует действие или усилие

to renew something - увеличить срок службы или заменить что-то старое; продлить, возобновить

an allegiance to someone or something - лояльность и поддержка правителя, страны, группы или веры; верность кому-то или чему-то

to beguile - очаровывать, привлекать или заинтересовывать, иногда для того, чтобы обмануть

barefaced - непоказывающий никакого стыда или пытающийся скрыть свое плохое поведение; неприкрытый, наглый, бесстыдный

inert - не имеющий внутренней силы действия, движения или сопротивления

elusive - трудный для описания, поиска, достижения или запоминания

frail - слабый или нездоровый, или легко повреждаемый или легко ломающийся; хрупкий

To date, ... - На сегодняшний день, ... 

tangible - реальный, а не воображаемый, который можно показать, потрогать или испытать; вещественный, ощутимый, реальный

to electrify someone by/with something - сделать человека или группу чрезвычайно взволнованными чем-то

unequivocally - абсолютным образом или не вызывая сомнений; категорически, однозначно

firsthand/ first hand / first-hand - говоря про информацию или опыт, полученый или изученый напрямую, а не от других людей или из книг; непосредственный, из первых рук

an armature - обычно вращающаяся часть электрической машины (такой как генератор или двигатель), состоящая в основном из витков проволоки вокруг металлического сердечника, в которой индуцируется электрический ток или в которой входной ток взаимодействует с магнитным полем для создания крутящего момента; якорь

quadruped - четвероногий

all-terrain - вездеходный

a hardsuit - силовой экзоскелет

adversely - таким образом, который оказывает отрицательное или вредное воздействие

a barb - острая изогнутая точка на конце стрелы или рыболовного крючка, из-за которой ее трудно вытащить; зазубрина

permissive - говоря про человека или общество, допускающий поведение, которое другие люди могут не одобрить; разрешающий, снисходительный, либеральный

ill-defined - неясно объясненный, описанный или показанный; плохо определенный

to splice - говоря про два куска веревки, пленки и так далее, соеденить вместе на концах, чтобы сформировать один длинный кусок

a screening for something - тест или обследование, чтобы выяснить, что что-то с кем-то не так; скрининг

an assessment - процесс рассмотрения всей информации о ситуации или человеке и вынесения суждения на основе этого; оценка, суждение

a cystic fibrosis - кистозный фиброз

a nearsightedness - близорукость

comprehensive - полный и включающий все необходимое; всесторонний, исчерпывающий, полный

out of interest​/​respect​/​pity/etc for something - из-за определенного чувства или отношения к чему-то

to digest something - переваривать что-то в желудке

sentient - способный воспринимать вещи через свои органы чувств

a frontier - граница между двумя странами

particularly - особенно

a saturation - насыщение, насыщенность

a crisp - хрустящая корочка

a sheet of something - большая, широкая масса чего-то вроде огня или льда

an auroral display - полярное сияние

to retract something - говоря про часть машины или механизма, или часть тела человека, перемещать вовнутрь или делать короче; втягивать или убирать

to loft something - бить по чему-то, например, по мячу для гольфа, чтобы запустить в воздух вверх

to intermingle - смешаться вместе с чем-то

to swat something with something - ударить, например, по насекомыму, чем-нибудь, особенно, плоским предметом или рукой; прихлопнуть, хлопнуть

to boil away something - выкипятить что-то полностью

to lay something on something - настроить орудие на правильное направление и высоту

an armament - вооружение или процесс вооружения

to gut something - полностью разрушить здание изнутри, обычно огнем

striped - полосатый

a burn - 1) расход топлива в качестве источника энергии
2) запуск ракетного двигателя в полете

to employ something - использовать что-то

a droplet - очень маленькая капля жидкости

a heat sink - радиатор или вентилятор с радиатором

a sink - реагент или поглотитель вещества

a wake - волны, которые оставляет за собой движущийся корабль или объект

a scaffold - строительные леса

a pressure hull - прочный корпус (в подводных лодках)

a baffle - устройство, например, пластина, стена или экран, для отклонения, проверки или регулирования потока или прохода жидкости, света или звука; перегородка

away from prying eyes - приватно, где люди не могут видеть, что вы делаете; подальше от посторонних глаз

beyond something - кроме как, за исключением

ever - постоянно (например, все ближе и ближе, все еще растет и так далее)

focal - фокальный

leading-edge - передовой

to confront someone with something - расскащать кому-то то, что они не хотят слышать, часто потому, что речь идет о чем-то плохом, что они сделали, или потому, что это требует объяснения

a butt - толстый конец рукояти ружья; приклад

acclaimed - хвалящего с энтузиазмом; признанный

to pillage - украсть что-то из места или у человека с применением насилия, особенно во время войны; разграбить

a carbonization - процесс изменения или превращения в углерод при сжигании, нагревании или во время окаменения; карбонизация

a contragravity - антигравитация

a charring - химический процесс неполного сгорания некоторых твердых веществ при воздействии высокой температуры; обугливание

a variable star - звезда, яркость которой меняется обычно более или менее регулярно; переменная звезда

variable - говоря про звезду, измененяющая свою яркость

a telltale sign of something - верный или явный признак чего-то

to scribble something - написать или нарисовать что-то быстро или небрежно; нацарапать

to score something - сделать отметку или надрез на поверхности чего-либо твердого остроконечным инструментом

irradiated - облученный

an excursion - экскурсия

a shoal - большое количество рыб, плавающих группой; косяк рыб

aloft - в воздухе или в более высоком положении

a bioluminescence - биолюминесценция

hushed - спокойный, неподвижный и тихий; притихший, приглушенный

to warble - петь трелями или с множеством оборотов и вариаций

solemn - серьезно и без всякого юмора

through and through - полностью

an upbringing - воспитание

to be weighed down by something - очень беспокоится из-за чего-то, что доставляет вам большие проблемы

clear-cut - ясный или очевидный, нетребующий никаких доказательств

a virility - 1) состояние или качество мужественности; мужественный характер, энергия или дух; мужественность
2) сила продолжения рода

to make a killing - заработать много денег за короткое время и с небольшими усилиями

profusely - в больших количествах; обильно

a test tube - пробирка

to countermand - изменить уже отданный приказ, особенно отдав новый приказ

a feeler - одна из двух длинных частей на голове насекомого и некоторых других существ, которыми оно прикасается к вещам, чтобы узнать, что находится вокруг него; щуп

to put out feelers - внимательно постараться узнать о чувствах или планах других людей, чтобы знать, что делать дальше; прощкпать

tactful - й, чтобы не сказать и не сделать ничего, что может кого-то расстроить; тактичный

to put someone's foot in someone's mouth - сказать или сделать что-то, чего вы не должны были делать, особенно то, что смущает кого-то другого

to do the deed - заниматься сексом

pushy - ведущий себя неприятным образом, слишком стараясь получить что-то или заставить кого-то что-то сделать

to lever someone or something to somewhere - перемещаеть кого-то или что-то в какое-то мето с большим физическим усилием

face-first / facefirst - резко вперед, чтобы ударить что-нибудь лицом; лицом вперед

a household name - известный человек или организация, о которых знает большинство людей

a sidewalk - тротуар

to hang someone's head - склонить голову вниз из-за стыда или смущения

a charter - официальное заявление о правах народа страны, организации или конкретной социальной группы, согласованное или требуемое правителем или правительством; хартия, устав

a foxhole - небольшая яма, вырытая в земле во время войны или военного нападения, используемая небольшой группой солдат в качестве базы для стрельбы по противнику и в качестве укрытия от нападения

up close and personal - очень интимно и лично, особенно до неудобной или нежелательной степени

a pruning shears - секаторы

mean - говоря, например, про игру на музыкальном инструменте, очень хороший

a scuttlebutt - новости или информация, которая может быть или не быть правдой

to have a thing for someone - испытывать романтическое увлечение кем-либо, особенно незаметно для этого человека

to hold someone's own - быть таким же успешным, как другие люди или вещи в ситуации

to sic something on someone or something - приказать животному атаковать кого-то или что-то; натравить

exemplary - образцовый

to screw the pooch on something - облажаться в чем-то сильно

multilateral - включающий участие более чем двух групп или стран

a pamphlet - памфлет

a mast - мачта

a muck - грязь, земля или липкое природное вещество, такое как экскременты животных

to inveigle someone into something - убедить кого-то сделать что-то умным и нечестным способом, когда он не хочет этого делать; заманить

to run afoul of something - сделать что-то, что вам не разрешено делать, особенно нарушение правил или законов

indigenous - изначально живущий в каком-то месте, непереехавший туда откуда-то еще; местный

to stumble across/on/upon someone or something - обнаружить что-то случайно или случайно встретить кого-то; наткнуться

a solitude - ситуация одиночества, не имея вокруг себя людей

a lees - осадок ликера, например, вина, во время ферментации и выдержки

a zealot - человек, который имеет очень твердое мнение о чем-то и пытается заставить других людей тоже иметь его; фанатик, фанатический приверженец

to insinuate - намекать то, что что-то является плохим, не говоря это прямо

dense - тупой

five by five - выражение, используемое в телекоммуникациях для обозначения того, что сигнал принимается четко

to keep/hold in check - держать что-то под контролем

a homesteader - тот, кто идет жить и выращивать урожай на земле, предоставленной государством, особенно в прошлом

to stonewall - остановить развитие дискуссии, отказываясь отвечать на вопросы или говоря таким образом, чтобы мешать другим людям высказать свое мнение

to get/have a handle on something - понять и суметь справиться с чем-то или с какой-то ситуацией

to settle down - 1) стать спокойнее 
2) замолчать и начать уделять внимание чему-то

in a while / after a while - через некоторое время, обычно умеренно короткое время

dead-on / dead on - совершенно точно или правильно

a hard-ass / a hardass - жесткий, требовательный или бескомпромиссный человек

to spiral - говоря про ситуацию, быстро ухудшаться и становиться все труднее контролируемой; закручиваться по спирали

the grapevine - неофициальный, неформальный способ получения информации, узнавая ее от кого-то, кто услышал ее от кого-то другого; слухи

to rap someone's knuckles - мягко критиковать или наказывать кого-либо за неправильный поступок

iffy - не очень хороший в каком-то смысле; сомнительный (например, запах молока)

a termination shock - 1) граница, обозначающая один из внешних пределов влияния Солнца, где солнечный ветер резко замедляется
2) точка для пространства вокруг любой звезды
3) быстрое и разрушительное повышение температуры после прекращения мер по солнечной геоинженерии

a wild-goose chase - поиск, который совершенно безуспешен и является пустой тратой времени, потому что разыскиваемый человек или вещь не существует или находится где-то еще

to catch on to something - понять что-то

to be stuck up about something - быть гордым и считающим себя очень важным из-за чего-то

to fall together - случиться, сформироваться или успешно произойти из различных элементов или усилий

adverse - оказывающий отрицательное или вредное воздействие на что-то; побочный (например, эффект)

poignant - вызывающий или имеющий очень острое чувство грусти; острый, колкий

to run off at the mouth - болтать без умолку, особенно о неважных вещах

to leave off - остановиться или прекратиться

rushed - вынужденный делать что-то быстро или без особой осторожности; торопливый

high-strung - обладающий чрезвычайно нервным или чувствительным темпераментом

indomitable - никогда несдающийся и непризнающий, что потерпел поражение; неукротимый

way off - dовершенно неверный, ошибочный или дезинформированный

to pry - пытаться узнать личные факты о человеке; влезать в чужую жизнь

to pick up - начать что-то снова после перерыва или с места, на котором остановились

a foothold - сильная первая позиция, от которой можно добиться дальнейшего прогресса; плацдарм

to ball something - заставить что-то сформировать замкнутую круглую форму

a closure - чувство или действия, направленные на то, чтобы положить конец неприятной ситуации, времени или опыту, чтобы вы могли начать заниматься чем-то другим; завершение

prefab / pre-fab - изготовленый в стандартных размерах для отправки и сборки в другом месте

a shack - очень простое и маленькое здание из кусков дерева, металла или других материалов; лачуга, хижина

ramshackle - плохой или неаккуратно сделанный, может легко быть сломан или упасть; ветхий, разваливающийся, обветшалый

a rover - вездеход

to crumple something - скомкать что-то или смять, чтобы сделать складки

a furrow - борозда, колея

to put someone's ass on the line - лично брать на себя или подвергать себя какому-либо риску, опасности или ответственности

to drag someone's heels - делать что-то медленно, потому что вы не хотите этого делать; затягивать

to make off with something - сбежать с чем-то, особенно с чем-то украденным; скрытся

to clutch (at) something - держать что-то крепко, обычно потому, что вы боитесь или беспокоитесь; схватить, сжать

deafening - настолько громкий, что невозможно услышать что-либо еще; оглушающий

to swoop down on someone or something - 1) внезапно опуститься вниз, чтобы схватить или приземлиться на кого-то или что-то; спикировать
2) спуститься с верху на кого-то или что-то очень быстро и внезапно, чтобы напасть или схватить; наброситься

to loom - предстать в виде большой, часто пугающей или неясной формы или объекта; маячить

an implication - эффект, который какое-то действие или какое-то решение окажет на что-то еще в будущем; последствие

cagey - преднамеренно несообщающий много информации о чем-то или невыражающий мнения о чем-то

hazy - говоря про воздух или погоду, неясный; туманный

a core drill - колонковое бурение

beaded - украшенный бусами или бисером

rustic - простой и часто грубый на вид, типичный для сельской местности; деревенский

ragged - говоря про одежду, порванный и не в хорошем состоянии

interferometric - интерферометрический

an aperture - апертура

purportedly - говоря про что-то, правдиво, но вы не можете доказать эту правдивость чего-то; якобы

sparse - малый по количеству и рассредоточеный по площади

a hothouse - теплица

an outgassing - выделение газа, который был растворен, захвачен, заморожен или поглощен каким-либо материалом

a caldera - кальдера

to chime - говоря про колокола, издавать звонкий звук; звонить

to flash - говоря про данные, уничтожать ???

to cut to the chase - говорить или иметь дело с важными момементами чего-то и не тратить время на то, что не важно; перейти к делу

inconsequential - несущественный

a commodity - вещество или продукт, которым можно торговать, покупать или продавать; товар

an assailant - человек, нападающий на другого человека; нападавший

on the fritz - говоря про электрические или механические приборы, выведенный из строя, неисправный, сломанный

a ranching - деятельность по содержанию животных на ранчо; скотоводство

a blasting cap - небольшое взрывное устройство, которое в сочетании с запалом для подрыва более крупного взрывного устройства

a faceplate - защитный чехол для лица человека (как у водолаза)

to tap into something - суметь использовать что-то так, чтобы это приносило хорошие результаты

smart as a whip - очень умный

to make oneself scarce - уйти из сложной ситуации, чтобы избежать неприятностей

out of spite - назло

to be survived by someone - оставить после своей смерти кого-то продолжать жить без вас, например, ваших членов семьи

to pummel - легко победить кого-то в спорте

to fend someone or something off - успешно защитить себя от нападок, критики или других нежелательных вещей; отбиваться

to learn/know the ropes - постигать/знать все тонкости какой-то работы или деятельности

a stockade - 1) частокол
2) ограждение, в котором содержатся заключенные

a knucklehead - глупый человек

a flattery - лесть

a reenactment / re-enactment - реконструкция события

to rub it in - постоянно упоминать кому-то о его неудаче или ошибке, часто со злым умыслом

to get a kick out of something - быть в восторге от чего-то или получать удовольствие от наблюдения за чем-то

to impound something - говоря про полицию и прочее, конфисковать что-то

to step on someone’s toes - расстроить или взбесить кого-то, особенно задевая то, что является обязанностью этого человека

a bad, good, ill, etc. repute - плохая, хорошая, дурная и так далее слава

to levy - говоря про правительства или организации, требовать денежной суммы, такой как налог, от лица или организации

toe the line - делать то, что от вас ожидают, не причиняя никому проблем

on the take - получающий взятки или другой незаконный доход

to polish enough gizzard - подлизываться к какому-то авторитету

to sputter - 1) говорить с трудом и издавать короткие звуки, особенно если вы злы, потрясены или взволнованы
2) шумно выплевывать или выплевывать частицы пищи или слюны изо рта; брызгать слюной

a known quantity - кто-то или что-то, чьи способности или характеристики хорошо известны

to skulk - спрятаться или передвигаться, как будто стараясь не быть замеченным, обычно с плохими намерениями

beat it - используется, чтобы сказать кому-то уйти, особенно когда вы на него злитесь

to bounce back - быстро вернуться в нормальное состояние после сложной ситуации или события; оправиться

an indolence - праздность

a kikcback - платеж, сделанный кому-либо, особенно незаконно, для оказания помощи, работы или бизнеса; откат

crooked - нечестный

a rube - глупый и необразованный, потому что из деревни

meddlesome - вмешивающийся в чужие дела

a compatriot - друг или кто-то, с кем вы работаете

a flak - сильная критика или возражение

a running tally / running total - сумма, которая меняется, потому что к ней продолжают добавляться числа по мере того, как что-то прогрессирует; текущая или промежуточная сумма

fortuitous - говоря про что-то, что пойдет вам на пользу, незапланированое, происходящее случайно

to be disinclined to do something - не хотеть что-то делать из-за легкой неприязни или неодобрения; быть несклонный делать что-то

pinstriped - говоря про ткань или одежду, с рисунком из узких, обычно светлых, параллельных линий, которые обычно носят деловые люди для работы; в тонкую полоску

to set tongues wagging - давать повод для сплетен

not to rock the boat - не говорить и не делайть ничего, что может нарушить стабильную ситуацию; не раскачивать лодку

to play ball - согласиться работать с кем-то или помочь кому-то так, как они предложили

to belabor something - объяснить что-то больше, чем необходимо

a decon - a decontaminaion

a tolerance - величина, на которую могут измениться измерения или расчеты, но при этом оставаться приемлемыми

a stim - стимулирующий препарат

to flip out - сильно разозлиться или потерять контроль над собой от неожиданности или шока; сорваться

to be caught up in something - 1) быть вовлеченным в сложную или запутанную ситуацию; оказаться вовлеченным во что-то, быть втянутым во что-то
2) быть взволнованнм чем-то из-за чего с трудом думается о чем-то другом; быть охваченным чем-то, увлечься чем-то

pointedly - очень очевидным образом, обычно для выражения критики или неодобрения; демонстративно, стараясь подчеркнуть

an allele - аллель

to spout (something) - много говорить так, чтобы это было скучно или раздражало других людей

inconsiderate - недостаточно заботящийся о том, как их слова или действия повлияют на других людей; невнимательный

brash - проявляющий слишком много уверенности и слишком мало уважения; дерзкий, нахальный

vague -  неспособный ясно мыслить или производящий впечатление неясного мышления, чтобы скрыть свои настоящие мысли

cryptic - таинственный и трудный для понимания

to be swathed by something - быть обвернутым или окутанным чем-то

to atone - сделать что-то, что покажет, что вы сожалеете о чем-то плохом, что вы сделали, или о том, что вы не сделали; искупить

a discordance - неприятный звук или сочетание звуков; диссонанс

candidly - честно и правдиво, особенно о чем-то трудном или болезненном; откровенно

cross my heart and hope to die - используется, чтобы показать, что то, что вы только что сказали или пообещали, полностью верно или искренне

a cloud hanging over someone - ситуация или будущее событие, которое заставляет вас волноваться или чувствовать себя несчастным

inland - находящийся посреди страны, вдали от моря

a beachfront - полоса земли вдоль пляжа

to cut corners - экономить деньги или время, делая что-то, не включая некоторые части, действия или детали, чтобы результат был не таким хорошим, как мог бы быть

to come to terms with something - научиться принимать что-то трудное или неприятное и справляться с этим; смириться с чем-то

a jolt - 1) внезапное резкое движение; толчок, тряска
2) неприятное потрясение или неожиданность

to cut loose - вести себя неконтролируемо, дико

a blowhard - высокомерный и напыщенный хвастливый или самоуверенный человек; хвастун

a whatnot / and what have you - и другие подобные вещи

in irons - в кандалах или оковах

to fall on one's sword - добровольно взять на себя вину за ситуацию

a pool - бильярд

a still - перегонный куб, дистиллятор

entitled - ведущий себя так, как будто имеет особые привилегии

to bail - прекратить что-то делать или покинуть место до того, как что-то будет закончено

to get/gain the upper hand - занять более сильную позицию, чем кто-либо другой, чтобы контролировать ситуацию; взять вверх

bag and baggage - со всем имуществом; полностью

to kowtow - проявлять слишком много уважения к кому-то, кто имеет власть, всегда делая то, что вам говорят, и меняя то, что вы делаете, чтобы угодить им; присмыкаться

to get someone's act together - начать организовывать себя так, чтобы делать вещи эффективно

to commence something - начать что-то

to assert oneself - вести себя таким образом, который выражает вашу уверенность, важность или власть и вызывает уважение у других; заявить и себе

to put a pin in something - перестать сосредотачиваться или работать над чем-то до тех пор, пока не появиться возомжномть закончить это в более позднее время; отложить

to rise to the occasion/challenge - показать, что вы можете успешно справиться с трудной ситуацией; оказаться на высоте

a hellcat - вспыльчивый темпераментный человек

to keep a stiff upper lip - сохранять мужество или самообладание в трудные времена, не уступая и не раскрывая своих эмоций; держаться молодцом

a cheesy smile - широкая, не не искренняя улыбка

an albedo - альбедо

to fine-tune something - внесите очень небольшие изменения во что-то, чтобы заставить это работать как можно лучше

pronounced - очень заметный или определенный; ярко или очень выраженный

to allude to someone/something - упоминать кого-то или что-то, не говоря прямо; намекать

a parentage - родители и/или страна родителей и социальный класс; происхождение, корни

lush - имеющий много очень здоровой травы или растений

a homestead - 1) дом и прилегающая территория земли, обычно используемая в качестве фермы
2) в прошлом, земля, предоставленная правительством для ведения сельского хозяйства

to stencil - наносить узор по трафарету

tops - максимум, в самой большой степени

a brood - группа птенцов, рожденных в одно и то же время от одной матери; выводок

a scuttle - неглубокая открытая корзина для переноски чего-либо (например, зерна или садовых продуктов)

erratic - непостоянный, неопределенный или неорганизованный в своем движении или поведении; неустойчивый

palpable - настолько очевидный, что легко можно увидеть или узнать, или говоря о чувстве, настолько сильное, что кажется, будто его можно потрогать или физически ощутить; ощутимый

to fork over/up something - отдать что-то, особенно деньги кому-то, особенно когда не хочется; раскошелиться

close-knit - говоря про группу людей, помогающие и поддерживающие друг другу; сплоченный

a skyway - эстакада

an exemption - специальное разрешение не делать что-то или не платить за что-то; освобождение, льгота

diffuse - разбросанный и ненаправленый в одно место

meandering - расположенный или идущий извилистым или непрямым путем; извилистый

a weave - плетение

a bean counter / a bean-counter - бухгалтер

to assay something - 1) анализировать, например, руду, на один или несколько конкретных компонентов
2) оценить ценность чего-то

an insecticide - средство для истребления насекомых; инсектицид

a transgression - действие или процесс нарушения закона или морального правила, или пример таковых; нарушение, проступок

to scurry somewhere - двигаться куда-то быстро и поспешно маленькими, короткими шажками, особенно потому, что вы напуганы

endemic - эндемичный

a liability - 1) долги
2) что-то или кто-то, что доставляет вам много неприятностей, часто тогда, когда этот предмет или человек должен вам помогать
3) все, что снижает ваши шансы на успех или вызывает трудности

a ripple - 1) небольшая волна на поверхности воды; рябь
2) звук или ощущение, которое распространяется через человека или группу людей, постепенно усиливаясь, а затем уменьшаясь; волна

a disciple - человек, который верит в идеи и принципы кого-то известного и пытается жить так, как живет или жил этот человек; ученик, последователь, адепт

an inaction - неспособность сделать что-либо, что могло бы обеспечить решение проблемы; бездействие

to go to any/great lengths to do something - очень стараться добиться чего-то; пойти на многое, на все, или на что угодно

damning - показывающий, что что-то не так или плохо, или что, кто-то сделал что-то неправильное или плохое

a tuft - несколько коротких прядей волос, травы и тому подобного, сросшихся вместе или скрепленных у основания; пучок

a pollen - пыльца

a methanotroph - метанотрофные бактерии

a precursor - что-то, что произошло или существовало до другой вещи, особенно если оно либо развилось в нее, либо оказало на нее влияние; предшественник

potable - безопасный и пригодный для питья; питьевой

a sweeping curve - длинная широкая кривая или изгиб

to pile something up - складывать большое количество вещей, чтобы образовать из них кучу; накапливать

to subduct something - забрать или вычесть что-то

a slip - относительное перемещение горных пород по плоскости разлома

a transform fault - трансформный разлом

a landslide / a landslip - масса камня и земли, внезапно и быстро движущаяся вниз по крутому склону; оползень

a rubble - оставшиеся куски кирпича, камня или других материалов, особенно после разрушенного дома

to stand in mute testament to something - являться немым свидетельством чего-то

picturesque - привлекательный внешне, особенно в старомодном стиле; живописный

a drive - запланированное усилие для достижения чего-либо

to gear someone or something up - подготовиться к чему-то, что вы должны сделать, или подготовить кого-то к чему-то

a set - место, где ставится или записывается фильм или спектакль, а также картины, мебель и так далее, которые используются; съемочная площадка, декорации

in​/​during​/​over the course of something - пока что-то происходит или продолжается; в ходе чего-то, в течение чего-то

slippery - мокрый или гладкий, из-чего легко скользящий или заставляющий что-то скользить; скользкий

a cinder - небольшой кусок частично сгоревшего угля или дров

sunbaked / sun-baked - говоря про территорию, очень сухая и, очевидно, получающая много солнца; залитая лучами солнца, вызженная солнцем

a chlorate - хлорат

to get out of Dodge - покидать какое-то место, особенно трудное или опасное место, со всей возможной поспешностью

to sift through something- 1) буквально, просеять какое-то вещество через сито или подобный инструмент, чтобы удалить более мелкие частицы или вещи; просеять
2) провести тщательное исследование какого-либо вещества или группы веществ с целью выделения или удаления чего-либо; просеять
3) осматривать какие=то вещи, чтобы найти что-то

wistful - полный тоски или желания с оттенком меланхолии

stale - говоря про еду и похожее, несвежая

to pry open - использовать силу рычага, чтобы открыть что-либо

a treatise - официальное письменное произведение, в котором рассматривается и исследуется конкретный предмет; трактат

a brushwork - особая манера художника наносить краску на картину кистью; манера или стиль письма

a watercolor - акварель

a scribe - человек, делавший письменные копии документов до изобретения книгопечатания; писец

punitive - предназначенный в качестве наказания; карательный

full of it - 1) ошибающийся или говорящий неправду
2) говорящий глупости
3) озорной, непослушный

to accord someone - обращаться с кем-то особым образом, обычно проявляя уважение

a bile - 1) горькая желтая жидкость, вырабатываемая печенью, которая помогает переваривать жир; желчь
2) очень злые чувства, слова или поведение; желчь

a crackpot - 1) тупой или глупый человек или идея
2) тот, кто склонен к эксцентричным или сумасшедшим идеям

a tribute - 1) что-то, что вы говорите, пишете или дарите, что показывает ваше уважение и восхищение кем-то, особенно в официальном случае; дань уважения
2) платеж одного правителя или нации другому в знак признания подчинения или в качестве платы за защиту, а также: налог, взимаемый с такого платежа; дань

to condone something - принять, проигнорировать или разрешить поведение, которое является неправильным; мириться с чем-то

to reprimand someone - сердито или серьезно говорить с кем-то за то, что он сделал что-то не так, обычно это делает человек, наделенный властью; сделать или объявить выговор

to blow a gasket - внезапно сильно разозлиться, вспылить в гневе

to wane - становиться слабее в силе или влиянии; ослабевать, идти на убыль

to neuter someone or something - кастрировать кого-то или что-то

head-on / head on - прямо или напрямую

a martyr - человек, который очень страдает или убит из-за своих религиозных или политических убеждений, и из-за этого часто вызывает восхищение; мученник

to recap something - повторить основные моменты объяснения или описания; кратко резюмировать или кратко повторить

a solace - помощь и утешение, когда вы грустите или беспокоитесь; утешение

to fumble - делать что-то неловко, особенно руками; возиться

to mire in something - погрязнуть в чем-то

a deity - бог или богиня (в политеистической религии); божество

a reprieve - любая отсрочка, которая приветствуется

to sway someone into something - убедить кого-то поверить или сделать что-то одно, а не другое

a landmark - здание или место, которое легко узнать, особенно то, по которому вы можете судить, где вы находитесь; ориентир, достопримечательность

for the duration (of something) - до тех пор, пока длится определенная ситуация

deft - очень умелый и быстрый в движении; ловкий

an infightning - 1) соревнование между людьми внутри группы, особенно для улучшения своего положения или достижения согласия в отношении своих идей; внутренняя борьба
2) споры или конкуренция между членами группы за власть или влияние; внутренняя борьба

infirm - больной или нуждающийся в уходе, особенно в течение длительного времени и часто из-за преклонного возраста; немощный, дряхлый

baroque - сложный по стилю, часто когда это не нужно или чересчур

to go it alone - решить сделать что-то самостоятельно, без помощи других людей

hip deep / hip-deep - очень сильно во что-то вовлеченный или большое количество чего-то

a klick - a kilometre (informal)

steep - говоря про склон, поднимающийся или опускающийся под острым углом

a foreboding - ощущение, что скоро произойдет что-то очень плохое; дурное предчувствие

benign - приятный и добрый; мягкий, безвредный

a census - перепись населения

relentless - говоря про что-то плохое, никогда неостанавливающийся и никогда нестановящийся менее интенсивным; безжалостный

to be on the cusp of something - быть в то время, когда ситуация в чем-то или состояние чего-то будут меняться; быть на пороге чего-то

a contingency - что-то, что может произойти в будущем, обычно вызывая проблемы или требуя дополнительных мер; непредвиденное обстоятельство

feverish - неестественно возбужденный или активный; лихорадочный

of someone's/that/this/the ilk - кому-то или чему-то подобный, или чьего-то рода по фамилии

a rundown / a run-down - краткий обзор или краткое изложение основных моментов информации, как правило, в устной форме; краткий отчет

to intertwine with something - переплетаться с чем-то

an omnivore - всеядное животное

consummate - 1) полный в каждой детали; совершенный
2) чрезвычайно опытный и натренированный
3) высшей степени; непревзойденный

a demeanor - то, как вы себя ведете, что дает людям представление о вашем характере и чувствах; поведение, манера вести себя

a pest - насекомое или мелкое животное, наносящее вред или наносящее ущерб посевам; вредитель

alternately - попеременно

a subgenus - категория в биологической классификации, стоящая ниже рода и выше вида; подрод

petty - 1) имеющий второстепенный ранг или важность; мелкий
2) имеющий немного или вовсе неимеющий большого значения или значимости; мелкий, незначительный

to write someone/something off - решить, что конкретный человек или вещь не будут полезными, важными или успешными; списать со счета

expedient - полезный в конкретной ситуации, но иногда неприемлемый с моральной точки зрения; выгодный

an sovereign - тот, кто обладает или считается обладающим высшей политической властью или суверенитетом

to hint at something - намекать косвенно на что-то

staggering - настолько великий или большой, что заставляет пошатнуться или ошеламиться; ошеломляющий, поразительный

an alacrity - быстрота в ответе на что-то; веселая готовность к чему-то

fluid - плавный и изящный

a guerrilla - член неофициальной военной группы, которая пытается сменить правительство, совершая внезапные и неожиданные нападения на официальные армейские силы; партизан

a pantheism - пантеизм

haplo-diploid - гапло-диплоидный

a clutch - гнездо яиц или выводок цыплят

cloistered - заточенный

a dynast - один из серии правителей или лидеров, которые все из одной семьи; династ

a kingpin - главное лицо в группе или в каком-то деле

shrewd - имеющий или основывающийся на четком понимании и здравом суждении ситуации, что приводит к преимуществу

an academia - часть общества, особенно университеты, которая связана с учебой и мышлением, или деятельностью или работой по обучению; научные круги

a duchy - герцогство

a fiefdom - территория, над которой кто-то осуществляет контроль в качестве или в порядке феодала; вотчина

labyrinthine - используется для описания чего-то, что состоит из множества частей и поэтому сбивает с толку; запутанный, подобный лабиринту

matrilineal - относящийся к, основанный на или прослеживающий происхождение по материнской линии

to interbreed with someone - скрещиваться с кем-то

a march - пограничный район или граница, особенно район, первоначально созданный для защиты границы

to comprise something - состоять из чего-то или включать что-то в себя

a sibling - один из двух или более олюдей, имеющих одного общего родителя

to diminish - постепенно становятся меньше по размеру или важности

a rules of engagement - правила применения оружия

to do something well before someone else - что-то сделать задолго до или гораздо раньше, чем кто-то другой

to prosecute something - продолжать принимать участие в запланированной группе мероприятий, особенно в войне; вести

preemptive / pre-emptive - превентивный, упреждающий

to telegraph something - передать кому-то сообщение или дать понять, что вы собираетесь делать, часто тем, как вы действуете

rocky - неопределенный и трудный и, вероятно, который не продлится долго; неустойчивый (например, отношения)

to puncture something - сделать что-то бесполезным или неэффективным, как будто проколоть

worrisome - worrying

covertly - тайно

a dissent - сильное расхождение во мнениях по определенному вопросу, особенно в отношении официального предложения, какого-то плана или распространенного мнения; несогласие, разногласие

troublesome - доставляющий много проблем

a hinge - 1) шарнирное или гибкое устройство, на котором поворачивается дверь, крышка или другая качающаяся часть
2) гибкий связочный сустав

a hinge point - точка, где что-то поворачивается

clear-eyed - 1) проницательный
2) имеющий ясные глаза или острое зрение

remorseless - серьезный и не проявляющий печали или вины; безжалостный

susceptible - легко подвергающийся влиянию или повреждению чем-то; воспроиимчивый, чувствительный

a dextro-amino acid - декстро-аминокислота

a levo-amino acid - лево-аминокислота

a meritocracy - меритократия

tempered by/with someone or something - сдерживаемый, ограниченный или контролируемый кем-то или чем-то

to muster out - уволиться со службы

to curb something - проверять или контролировать что-то с помощью или как-будто бордюром; сдерживать

an import - важность, значимость

a hands-off policy - политика или подход к чему-то, который состоит в том, чтобы не быть лично или непосредственно вовлеченным; политика невмешательства

recreational - связанный со способами получать удовольствие, когда вы не работаете; развлекательный

a qualm - неприятное чувство, когда сомневаешься, правильно ли поступаешь; колебание, сомнение, опасение

an egotism - эготизм

to tempt someone to do something - искушать, соблазнять или побуждать кого-то сделать что-то

a misdeed - действие, которое является преступным или плохим; злодеяние

to transcend - выходить за обычные пределы или границы, потому что являетесь более значимым, чем они

to embody soomething - олицетворять что-то

a tranquility - мирное, спокойное состояние, без шума, насилия, беспокойства и так далее; спокойствие

to appeal to someone to do something / for something - обратиться к кому-то с серьезной и настоятельной просьбой о чем-то

an intercession - акт использования вашего влияния, чтобы заставить кого-то, кто обладает властью, простить кого-то другого или спасти его от наказания

to converse with someone - поговорить с кем-то

nigh - 1) рядом в пространстве, времени или отношениях
2) почти

rather than something, ... - вместо чего-то, ... 

a circulatory system - сердечно-сосудистая система

a fluid - вещество, которое течет и не является твердым

a lean times - тяжелые или голодные времена

a cauldron of something - 1) говоря про какую-то ситуацию, что-то нестабильное или опасное
2) что-то похожее на кипящий котел по интенсивности или степени волнения

blunt - говорящий то, что думает, непытаящийся быть вежливым и непринимающий во внимание чувства других людей; прямой, резкий

as a matter of course - само собой разумеющееся

solitary - существующий, живущий или идущий в одиночку или без спутников

to stem from something - начинаться или развиваться в результате чего-то

to be out to get someone - умышленно создавать проблемы для кого-то

rugged - сильный и простой; не деликатный

to incapacitate someone or something - сделать кого-то или что-то неспособным нормально работать или делать что-то, или неспособным сделать то, что намеревалось; выводить из строя

spit and polish - чрезвычайное внимание к чистоте, порядку, опрятности внешнего вида и церемониям, часто в ущерб эффективности работы; наведение порядка для показухи

callous - очень жестокий и непроявляющий заботы о других людях или их чувствах; бессердечный

at someone's disposal - в чьем-то распоряжении

an attrition - процесс, в котором вы постепенно уменьшаете силу врага, постоянно атакуя его; истощение

much as - почти также как и

an enforcement - правоприменение

lenient - не столь суровый или сильный в наказании или приговоре, как можно было бы ожидать; снисходительный

odious - одиозный

a point of friction between someone and someone else - точка трениями между кем-то

at a premium - нераспространеный и поэтому ценный

a disdain - чувство, что вам не нравится кто-то или что-то и вы думаете, что они не заслуживают вашего интереса или уважения; пренебрежение

staid - серьезный, скучный и довольно старомодный; уравновешенный

long-proven - давно проверенный ???

to dish something out - давать или говорить что-то людям, не задумываясь об этом, часто в больших количествах; раздовать, выписывать

a shock - удар или столкновение отдельных лиц или групп в бою

to wither on the vine - завянуть на корню

a maxim - 1) общая истина, фундаментальный принцип или правило поведения
2) общеизвестная поговорка

token - выражающий чувства или намерения, хотя и возможно имеющий небольшой практический эффект; символический

a nexus - важная связь между частями системы или группами вещей; связующее звено

a legislation - закон или свод законов, предложенных правительством и официально принятых парламентом; законодательство

a submersion - погружение

a vogue - мода или общая симпатия, особенно временная

a jingoist - ура-патриот

to plough into someone or something - говоря про транспортное средство, с большой силой ударяться или врезаться в кого-то или что-то

to hinge on/upon someone or something - зависеть от кого-то или чего-то или быть под влиянием кого-то или чего-то

a wilderness - участок земли, который не использовался для выращивания сельскохозяйственных культур или на котором не были построены города и дороги, потому, что на нем трудно жить из-за чрезвычайно холодной или жаркой погоды или плохой почвы; дикая местность

an impunity - свобода от наказания или от неприятных последствий содеянного; безнаказанность

to garrison - размещать гарнизоны

coherent - 1) хорошо спланированный, чтобы быть ясным и осмысленным, и все его части хорошо сочетались друг с другом; последовательный, связный
2) обладающий качеством удержания вместе или когерентности; связный, сплоченный, скоординированный

en masse - все вместе и одновременно, в большом количестве

a blockade runner - блокадопрорыватель

veritable - используется для описания чего-либо как другого, более захватывающего, интересного или необычного, как способ подчеркнуть его характер; настоящий, буквальный (например, когда я вернулся из отпуска, мой сад превратился в настоящие джунгли)

a strobe light / a stroboscopic lamp / a strobe - стробоскоп, стробоскопическая лампа

to subdue someone - поставить человека или группу под контроль с применением силы; усмирить

an intruder - человек, который входит в место, где ему не положено быть; нарушитель, незванный гость

a ripple fire / a ripple-fire - пуск ракет в быстрой последовательности

reminiscent of someone or something - напоминающий кого-то или что-то

a rack - рама или полка, часто образованная из стержней, которая используется для хранения вещей; рамка

bolted - прикрепленный болтами

to sling something - бросить что-то куда-то небрежно

to magnify something - увеличить эффект, размер, громкость или интенсивность чего-то

a toll - общее количество смертей, ущерба, несчастных случаев или катастроф, произошедших за определенный период времени

to take its/a toll - вызывает страдания, смерть или ущерб

ravenous - очень голодный

a canteen - фляга

to be prone to something / to do something - проявлять определенную характеристику, обычно отрицательную, или быть затронутым чем-то плохим, например, повреждением или болезнью; быть склонным к чему-то

a persecution - несправедливое или жестокое обращение в течение длительного периода времени из-за расы, религии или политических убеждений; преследование, гонение

to ameliorate something - исправить плохую или неприятную ситуацию или сделать ее лучше

a panoply of something - широкий ассортимент или набор разных вещей; арсенал

(by) courtesy of someone or something - любезно предоставленный кем-то или чем-то

sub-dermal / subdermal - подкожный

to take (great) pains to do something - очень сильно стараться сделать что-то; прикладывать большие усилия

broad-minded - готовый принять множество различных типов поведения, убеждений или выборов других людей; имеющий широкий кругозор

a bioluminescence - биолюминесценция

prefabricated - говоря про здания или объекты, строящиеся из частей, изготовленных на заводе, и которые можно быстро собрать; сборный

a solarium / a conservatory - комната со стеклянными стенами и стеклянной крышей, обычно соединенная с домом, используемая для выращивания растений или для отдыха в ней

a last resort - единственный выбор, который остается после того, как были испробованы все остальные; последнее средство

to stave someone or something off - остановить что-то плохое или удержать нежелательную ситуацию или человека, обычно временно

cellular - связанные с клетками растений или животных; клеточный

anecdotal - состоящий из или основанный на отчетах или наблюдениях обычно ненаучных наблюдателей

climacteric - климактерический

to dispense something - раздавать что-то другим людям

a confederacy - конфедерация

an accommodation - соглашение между двумя группами, имеющими разные мнения по вопросу, или процесс достижения этого; компромисс

an impetus - что-то, что поощряет определенную деятельность или делает эту деятельность более энергичной или эффективной; импульс, толчок, стимул

a principality - страна, управляемая принцем или от которой принц берет свой титул; княжество

free-wheeling / freewheeling - неограниченный правилами или принятыми способами ведения дел; свободный

a legislature - законодательная власть

a plebiscite - плебисцит

to lend credence​/​plausibility​/​weight/credibility to something - сделать так, чтобы что-то казалось истинным или правильным; придавать больше веса чему-то

a secularism - секуляризм

to revere someone or something - очень уважать и восхищаться кем-то или чем-то; почитать, чтить

surmountable - преодолимый (например, проблема или препятствие)

to be reduced to something - быть приведенный к систематической форме или характеру; привести к чему-то

exhaustive - говоря про исследования, поиск или список, очень тщательный и полный; исчерпывающий

an awareness - знание того, что что-то существует, или понимание какой-то ситуации или предмета в настоящее время на основе информации или опыта; осведомленность, сознание

a chastisement - суровая критика или наказание

to forsake someone or something - 1) бросить кого-то, когда вы должны были остаться, или перестать помогать кому-то или заботиться о ком-то; бросить
2) перестаете что-то делать, использовать или иметь; оставить, бросить
3) покинуть какое-то место, особенно надолго или навсегда

to venerate someone or something - в основном говоря о религиозных темах, ценить или испытывать большое уважение к кому-то или чему-то; почитать

an outlook on something - общее отношение или способ мышления человека о чем-то; взгляд на что-то

an agency - человек или вещь, посредством которых проявляется сила или достигается цель; посредник, посредничество

rather, ... - точнее, ...; скорее, ...

to wrought something (only as a past participle and in the past tense) - быть причиной чему-то; навести, вызвать (например, хаос)

a hubris - крайнее и необоснованное чувство гордости и уверенности в себе

Stanford torus - Стэнфордский тор

a Lagrange point - Точка Лагранжа

to home to someone - быть для кого-то домом

a chokepoint / a choke point - стратегический узкий маршрут, обеспечивающий проход через или в другой регион

an incursion - внезапное, обычно маломасштабное без цели захватить территорию, нападение или акт проникновения в какое-либо место, особенно через границу; вторжение

Bernal sphere - Сфера Бернала

a heliopause - гелиопауза

an interstellar medium - межзвездная среда

moot - 1) неважный или неактуальный, поэтому нестоящий обсуждения; спорный
2) лишенный практического значения; абстрактный или чисто академический

to refurbish something - сделать здание снова новым, выполнив такие работы, как покраска, ремонт и уборка

to refurbish something as something else - переоборудовать здание под какие-то нужды ???

a temperance - воздержание от чего-то

a barycenter - барицентр

a mnemonics - мнемоника
	
a think tank - группа экспертов, собираемая, как правило, правительством, для разработки идей по конкретному вопросу и внесения предложений для действий

unapologetic - 1) непринимающий вину или ошибку; бескомпромиссный, непримиримый
2) непоказывающий сожаления

Nietzschean - относящийся к Фридриху Ницше или характерный для него; ницшеанский

sublight / sub-light - меньше скорости света

a reaction mass - топливо для атомной энергетики

a barge - баржа

to vent something - выпускаете что-то наружу, часто с целью охлаждения или проветривания

a power plant - электростанция или силовая установка

a propellant - взрывчатое вещество или топливо, которое заставляет что-то двигаться вперед

a matter-antimatter annihilation - аннигиляция материи с антиматерией

an exhaust - отработавший газ двигателя, особенно автомобильного, или труба, по которой протекает газ; выхлоп

a wax - воск

a blowtorch / a blowlamp - паяльная лампа

to attain something - достичь или преуспеть в получении чего-то, что трудно сделать или получить