covert - скрытый или секретный, тайны; открыто не признанный

spacefaring - имеющие транспортные средства, способные путешествовать за пределы земной атмосферы

a thruster - двигатель (например, реактивный двигатель), который развивает тягу за счет выброса струи жидкости или потока частиц

a buoy - буй

a fatigue - усталость, утомление или истощение от работы, физической нагрузки, напряжения или стресса

to dissipate - постепенно исчезать и растрачиваться; рассеиваться

to excel - быть чрезвычайно хорошим в чем-то; превосходить

to tint + a color - слегка окраситься в какой-то цвет

for the betterment of someone or something - ради улучшения кого-то или чего-то

to cultivate something - опытаться что-то развить и улучшить

intrinsic - принадлежащий к неотъемлемой природе или сущности чего-то или кого-то; присущий, неотъемлемый

a spoke - спица в колесе

an angle of depression - угол, образованный горизонтальной линией и линией, соединяющей объект и глаз наблюдателя

an elevation - градус наведения орудия над горизонтом

a cargo hold - грузовой отсек

on the fringe(s) of something - на краю чего-то

Attican Traverse - Аттический Траверс

to raze something - полностью уничтожить, например, город или здание; снести, сравнять с землей

to lay siege to something - говоря про полицию, солдат или журналистов, окружать какое-то место, чтобы заставить людей выйти или отказаться от контроля над этим местом; осаждать

to perish - умереть, особенно в результате несчастного случая или будучи убитым, или быть уничтоженным; погибнуть

a prospector - человек, который ищет золото, нефть или другие ценные вещества на поверхности земли или под ней; старатель

downwind - двигающийся, куда движется ветер

a thresher - 1) человек или машина, отделяющая зерно от растений путем отбивания; молотилка, молотильщик 2) акула, живущая на поверхности, с длинной верхней долей хвоста, часто охотятся парами, хлеща хвостом по воде, 
чтобы собрать рыбу в плотную стаю; молотилка, молотильщик

a maw - пасть

to devour something - съесть что-нибудь жадно и в больших количествах, чтобы ничего не осталось; пожирать

in retaliation for something - в отместку за что-то

an animosity - сильная неприязнь, противостояние или гнев; враждебность, неприязнь, вражда

supranational -включающий участие более чем одной страны или имеющий власть или полномочия, превышающие полномочия отдельных стран; наднациональный, надгосударственный

piecemeal - характеризующийся бессистемными частичными мерами, принимаемыми в течение определенного периода времени

jointly - совместно, сообща

to dither - быть не в состоянии принять решение о том, чтобы сделать что-то; колебаться

to bicker about/over something - спорить о вещах, которые не важны

a debriefing - разбор полетов

under false pretenses - под ложным предлогом

a shakedown run - акт испытаний новой единицы оборудования, в частности транспортного средства

an infirmary - комната в школе, колледже или университете, где учащиеся, получившие травму или плохо себя чувствующие, могут обратиться к медсестре для лечения; лазарет

a picket - отдельный отряд солдат, служащий для охраны армии от неожиданностей

an envelope - что-то, что обволакиваетж; обертка, оболочка

a Doppler effect - изменение, которое кто-то испытывает в частоте волн, например звука или света, когда изменяется расстояние между этим человеком и источником волн

to deem - рассматривать или судить о чем-либо определенным образом

backroom - совершено тайно или не привлекая внимания

contentious - вызывающий, вовлекающий или способный вызвать разногласия и споры; спорный, противоречивый

the bulk of something - большинство чего-то

to evict someone from somewhere - заставить кого-то уйти откуда-то; выселить

a truce - кратковременный перерыв в войне или споре, или соглашение прекратить борьбу или спор в течение определенного периода времени; передышка