tenacious - нежелающий принять поражение или перестать что-то делать или владеть чем-то; упорный, упрямый

a prompt - 1) знак на экране компьютера, показывающий, что компьютер готов принять ваши инструкции
2) напоминание, подсказка

a discretion - 1) умение вести себя, не вызывая смущения и не привлекая лишнего внимания, особенно сохраняя информацию в тайне; осмотрительность, осторожность
2) право выбирать что-то или что-то делать в зависимости от того, что кажется наиболее подходящим в конкретной ситуации; усмотрение

a disarray - состояние запутанности и неорганизованности или неопрятности; беспорядок, смятение

a hollow victory - бессмысленная победа; Пиррова победа

synaptic - синаптический

to incinerate something - сжечь что-то полностью

a vanguard - войска, движущиеся во главе армии; авангард

an ablation - 1) удаление льда или снега с ледника или айсберга, или удаления камня или подобного материала, вызванное такими процессами, как таяние или эрозия, например, постепенное повреждение и удаление волнами, дождем или ветром; абляция
2) медицинское лечение, которое включает в себя удаление или разрушение небольшого количества ткани из организма, например, с помощью тепла или холода; абляция

to entrench - 1) разместиться внутри или окружить себя траншеей для защиты; закрепиться, укрепиться
2) поставить себя в сильную оборонительную позицию; закрепиться, укрепиться

a regimen - любой набор правил о еде и физических упражнениях, которым кто-то следует, особенно для улучшения своего здоровья; режим

paramilitary - организованный как армия, но являющийся неофициальным и часто незаконным, при это зачастую связанный с официальными вооруженными силами и помогающий им; полувоенный, военнизированный

a shut-eye / a shuteye - сон

be my guest! - что-то, что вы говорите, когда даете кому-то разрешение сделать или использовать что-то

lingering - длящийся долго, затяжной

to deride someone or something (as something) - смеяться над кем-то или чем-то таким образом, чтобы показать, что вы считаете их глупыми или бесполезными

sole - единственный в своем роде, единственный

to denounce someone as something - публично обвинить кого-то в том, что он плохой или неправильный

a shell company - компания, которая сама ничем не занимается и не владеет, но используется для сокрытия деятельности человека или другой компании, иногда незаконной; подставная компания

a compaction - процесс, при котором давление на погребенный твердый материал заставляет материал слипаться; уплотнение

versatile - говоря про инструмент, машину или материал, имеющий способность использоваться для самых разных целей; универсальный

stand-alone - автономный

a proponent - лицо, публично выступающее в поддержку той или иной идеи или плана действий; сторонник, защитник

a kludge - что-то, особенно компьютерное оборудование или программное обеспечение, которое было собрано из всего, что есть в наличии, особенно когда оно работает не очень хорошо

with the best of them - также хорошо, как и любой другой

ensuing - приходящий сразу после чего-то или происходящий в результате чего-то

a canopy - 1) покрывало, закрепленное над сиденьем или кроватью и тому подобным для укрытия или украшения; навес, полог, балдахин, тент
2) ветки и листья, которые раскинулись на вершине группы деревьев, образуя своего рода крышу
3) прозрачная часть военного самолета, закрывающая место, где сидит пилот
4) большой круглый кусок ткани, являющийся основной частью парашюта; купол парашюта

outermost - самый дальний, или самый дальний от центра или изнутри; самый внешний

porous - пористый

a rent - большая дыра, вырванная в куске материала

to stanch / to staunch - остановить течение жидкости, особенно крови

to ooze - медленно вытекать из чего-то через маленькое отверстие или медленно производить густую липкую жидкость; сочиться

at a moment's/two hours'/three weeks', etc. notice - используется, чтобы подчеркнуть, как мало времени у кого-то есть, чтобы что-то сделать, или как мало предупреждений дается; в любой момент

shaver - бритвенный ???

it was long thought that ... - долгое время считалось, что ... ???

to plateau - достичь определенного уровня, а затем оставаться одинаковым; выйти на плато

downrange / down-range - говоря про направления огня, от источника и в направлении к цели

to follow someone's lead - сделать то же самое, что сделал кто-то другой; последовать примеру

to turn the tide - изменить ситуацию, особенно так, чтобы вы начали выигрывать, а не проигрывать; переломить

to decimate someone or something - уничтожить большое количество людей, животных или других существ или причинить серьезный вред чему-то

an expletive - грубое слово или выражение, например «Черт!»?, которые вы произносите, когда раздражены, взволнованы или испытываете боль; ругань, ругательство

to forgo something - отказаться от чего-то или обойтись без чего-то, хотя вам бы этого хотелось

naturalistic - натуралистический

interlocking - прочно соединеные друг с другом, особенно за счет того, что одна часть входит в другую; сцепленный, взаимосвязанный

a sheath - плотно прилегающее покрытие для защиты чего-то; оболочка

a sheathing - плотно прилегающее покрытие, предназначенное для защиты чего-то; обшивка

a gross motor - крупная моторика

an ulna - локтевая кость

a forearm - предплечье

stretched thin - имеющий недостаточно времени или денег, чтобы делать то, что хочется

to reserve judgment on something - воздерживаться от высказывания мнения о чем-ир, пока не узнаете об этом больше

to commission someone or something - официально выбрать кого-то для выполнения особой работы или официально попросить кого-то выполнить особую работу; поручить, заказать

a scrubber - система или часть оборудования для удаления веществ, вредных для окружающей среды, из газа; скруббер

an intermediary - кто-то, кто действует, чтобы договориться между людьми, которые не хотят или не могут общаться напрямую; посредник

exorbitant - говоря про цены, требования и так далее, слишком большие; непомерный

to be on the march - делать устойчивый прогресс или распространяться по области

a skew - косой угол; наклон, перекос

a reprisal - пример деятельности против другого лица, особенно в качестве наказания со стороны вооруженных сил или политической группы; расправа, возмездие

a big game - крупные дикие животные, на которых охотятся и отстреливают для спорта

an eviscerator - потрошитель

serrated - имеющий ряд острых точек по краю; зубчатый

to surface - говоря про новости, чувства или проблемы, становиться известным или всем очевидным; всплывать

an entanglement - состояние заворачивания и скручивания в массу; запутанность, запутывание

an yeoman - старшина военно-морского флота, выполняющая в основном канцелярские обязанности в ВМС США

taxed - имеющий обязанность прилагать много усилий, физических или умственных, и находищий это тяжелым; напряженный чем-то, подверженный чему-то

exhilarated by something - воодушевлнный или взволнованный чем-то

to take stock of something - тщательно обдумать ситуацию или событие и составить об этом мнение, чтобы вы могли решить, что делать дальше; подвести итог

hard line / hard-line / hardline - говоря про чью-то политику или отношение, строгая или крайняя, и маловероятно, что будет изменена; бескомпромиссная

checkered / chequered - имеющий как успешные, так и неудачные периоды в прошлом; пестрый

to be of a kind - быть того же класса, характера, природы и так далее

high-profile - привлекающий большое внимание и интерес со стороны общественности, газет, телевидения и так далее

would-be someone or something - желающий или пытающийся быть кем-то или чем-то

on the off chance that ... - используется, чтобы сказать о чем-то, надеясь, что это имеет возможность быть, хоть это и маловероятно

to strike a deal - прийти к соглашению

to wrap something up - завершить или закончить что-то

a rover - вездеход

that is to say / that's to say - используется, чтобы указать, что вы собираетесь выразить ту же мысль более ясно или точно; то есть

to send someone or something by some means - отправить кого-то или что-то с помощью определенного средства транспортировки или доставки

an incisor - резец

a busybody - человек, который слишком интересуется вещами, которые их не касаются

to put someone or something through their/its paces - заставить человека или машину показать, насколько хорошо они что-то делают; испытать

to compartmentalize something - разделить что-то на части и не позволять этим частям смешиваться вместе

to divulge something - разглашать что-то

to wage something - вести войну или организовать ряд действий, чтобы чего-то добиться; вести

to credit something to someone or something - приписывать что-то кому-то или чему-то

to take/get custody of someone or something - взять кого-то или что-то под опеку

unequaled - лучший в чем-то, чем кто-либо или что-либо другое того же рода; непревзойденный, бесподобный

to crunch something - вычислить числа или обработать информацию; подсчитать

a militia - военная сила, которая действует только некоторое время и члены которой не являются солдатами в постоянной армии; ополчение

to step up something - сделать что-то более эффективным или увеличить размер или скорость чего-то

to wear/use something in good health - использовать или носить что-то на здоровье

a resourcefulness - находчивость

complimentary - говоря про билеты, книги и так далее, выданный бесплатно, особенно бизнесом; бесплатный

on its/someone's (own) merits - основанный только на качествах человека или вещи, а не на том, что другие люди говорят об этом человеке или вещи; по свом достоинствам или заслугам

a caviar - икра

a fare - тип еды, которая подается в ресторане

namby-pamby - 1) лишенный характера или содержания; безвкусный
2) слабый, нерешительный

to pull your weight - работать так же усердно, как и другие люди в группе

to fall/slip through the cracks - не быть замеченным или быть тем, с чем не имели дело; упускаться или ускользать из виду

a butt pucker - слишком тугая задница

a squat - anything

to not see squat - ничего не видеть

an ingenuity - изобретательность

an air duct - воздухопровод

a vertigo - ощущение вращения и невозможности балансировать, часто вызванное взглядом вниз с высоты; головокружение

a dampener - демпфер

a landline - 1) телефон, подключенный к телефонной системе проводами
2) набор проводов, по которым передаются телефонные сигналы и которые соединяют дома и офисы с телефонной системой

to allay something - говоря про сильную эмоцию, испытываемую кем-то, например, страх или беспокойство, ослаблять; развеивать

to bog down someone or something in something - препятствовать тому, чтобы кто-то или что-то двигалось или прогрессировало; увязнуть кого-то или что-то в чем-то

to gauge something - судить о чем-то, обычно о чувствах людей

to shape up - улучшить свое поведение или производительность

a propulsion - сила, толкающая что-то вперед

a clout - власть и влияние на других людей или события

to backslide on something - вернуться к старым, часто плохим, привычкам или к худшему состоянию чего-то

an understatement - утверждение, описывающее что-то таким образом, что оно кажется менее важным, серьезным, плохим и так далее, чем оно есть на самом деле, или действие по созданию таких утверждений; преуменьшение

a daddy bag - яички

an attenuator - аттенюатор

a coupling - муфта

to discontinue something - прекратить делать или предоставлять что-то

a loft - чердак

a fitting - 1) одна из небольших деталей на внешней стороне оборудования или мебели, например, ручка или кран
2) примерка одежды

a fittings - вещи, как печи или обогреватели, которые устанавливаются внутри здания, но при необходимости могут быть удалены

fitting - подходящий для конкретной ситуации или случая

a plumbing fitting - фитинг

off the grid - нефиксируемый или неотслеживаемый обычными средствами

a willingness to something - качество быть счастливым сделать что-то, если это необходимо; готовность

to retain something - держать или продолжать иметь что-то

a familiarity with someone or something - хорошее знание о ком-то или о чем-то или тот факт, что вы знаете это так хорошо; знакомство

noted for something - известен многим людям, особенно благодаря особым качествам

a convict - тот, кто находится в тюрьме, потому что он виновен в преступлении; осужденный

a biped - двуногий

forensic - судебно-медицинский

a forensic accounting - судебная бухгалтерия

to yield something - поставлять или производить что-то положительное, например, прибыль, количество еды или информацию; дать

combative - агрессивный и готовый драться или спорить; воинственный

lucrative - говоря про бизнес, работу или деятельность, приносящий много денег

reclusive - проживающий в одиночестве и избегающий выхода на улицу или разговоров с другими людьми; замкнутый, затворник

a tycoon - человек, который преуспел в бизнесе, обычно в нескольких предприятиях или отраслях, и поэтому стал богатым и влиятельным; магнат

a maverick - человек, который думает и действует независимо, часто ведет себя не так, как ожидалось или как обычно он себя ведет; индивидуалист

to say the least - используется, чтобы показать, что то, что вы описываете, на самом деле гораздо серьезнее или важнее, чем вы предполагаете; мягко говоря, если не сказать больше

a front organization/company - организация, которая действует как лицо другой организации или группы, например, преступной группы или разведывательного агентства, чтобы скрыть деятельность этой организации или группы; подставная организация

to brand something - пометить животное, например корову, выжигая или замораживая его кожу, чтобы показать, что оно принадлежит вам; клеймить

a sedition - седиция

a power base - область или группа людей, от которых политик получает наибольшую поддержку и которые позволяют ему стать влиятельными; опора

an overrun - время завершения чего-то или стоимость чего-то, которые продолжаются после установленной даты или лимита; превышение сроков, перерасход

spectacular - очень впечатляющий или драматичный; захватывающий, зрелищный

a marshland - земля с большим количеством влажных, грязных участков; болотистая местность
	
a mountain range - группа или линия гор с определенным названием; горные хребты

a tightbeam / a tight-beam - (научная фантастика) сфокусированный луч энергии (например, лазер), который содержит и передает информацию

to supplant someone or something - заменять и служить заменой кому-то или чему-то, особенно по причине превосходства или силы; заменять, подменять

an airframe - планер летательного аппарата

axial - осевой

cramped - неимеющий достаточно места или времени; тесный, плотный

a sealant - герметик

the elements - погода, обычно плохая погода; непогода

substantial - большой по размеру, стоимости или важности; существенный, значительный

proverbial - 1) часто использующийся или являющийся частью популярной поговорки; вошедший в поговорку
2) очень хорошо известный многим людям; вошедший в поговорку

amenable to something - пригодный или подходящий для чего-то

as such - как таковой

a biota - флора и фауна

cutthroat / cut-throat - жестко и несправедливо конкурирующий, не принимая во внимание причинение вреда другим

strong-arm - использующий силу и угрозы, чтобы заставить людей делать то, что вы хотите

an indifference to/towards something - равнодушие или безразличие к чему-то

the latter - последний из двух

to retard something - замедлять что-то; тормозить

to thrust away from someone or something - бросаться прочь от кого-то или чего-то

a puff of something - небольшое количество чего-то, выдуваемое откуда-то

a mouth of something - говоря про пещеру, дыру, трубу или бутылку, вход или отверстие

to be subject to something - скорее всего испытывать что-то или страдать от чего-то; подвергаться

haptic - тактильный

an ease - простота (например, удобства)

to key something in - вводить информацию в компьютер или давать компьютеру определенные инструкции, набирая информацию или инструкции на клавиатуре

an accelerometer - акселерометр

to feel someone's way - 1) двигаться вперед осторожно, используя руки, чтобы чувствовать что-либо на пути; прощупывать свой путь
2) двигаться к цели очень медленно и осторожно; прощупывать свой путь

an alcohol wipe - спиртовая салфетка

clammy - липкий и немного мокрый неприятным образом

long since - уже давным-давно

a layover - краткое пребывание в месте, которое вы совершаете, пока находитесь в более длительном путешествии куда-то еще; остановка

impoverished - обедневший; обнищавший

an underclass - низшие слои общества; низший класс

to garner something - получить или заработать что-то ценное или уважаемое, часто с трудом

at times - иногда, временами

to give/make way to something - быть чем-то замененым, обычно чем-то более лучшим, дешевым, простым и так далее

to scrabble something - 1) использовать свои пальцы, чтобы быстро найти то, что вы не видите; рыться
2) пытаться получить что-то быстро, что не легкодоступно
3) пытается что-то сделать, имея возникаюющие трудности, потому что кто-то слишком торопится или потому что задача почти невозможна

blasted - используется во фразах для выражения гнева; чертов, проклятый

the long and the short of it - используется, когда вы хотите объяснить общую ситуацию, не давая подробностей; короче говоря

to keep someone on their toes - заставит вас оставаться бдительным и быть готовым ко всему, что может произойти; держать в напряжении

water under the bridge - проблемы, которые у кого-то были в прошлом, о которых они не беспокоятся, потому что они произошли давно и теперь не могут быть изменены

an angle - чья-то цель или интерес в чем-то

to repent of something - каяться или раскаиваться в чем-то

lest something - чтобы предотвратить любую возможность того, что что-то произойдет

with a bang - неожиданным и захватывающим способом

to dip something in something - положить что-то в жидкость на короткое время; опустить, обмакнуть

an extremity - часть человеческого тела, наиболее удаленная от сердца, например, пальцы рук, ног и нос; конечность

fleshly - относящийся к физическому телу, а не к уму или душе; плотский

base - не оказывающий никакой чести и не имеющий морали; низкий, низменный

to compel someone to do something - заставить кого-то сделать что-то; вынудить

a blight - 1) болезнь, которая повреждает и убивает растения
2) то, что портит или очень плохо на что-то влияет, часто надолго

to call the shots/the tune - быть в позиции принимать решения, которые влияют на ситуацию

up for grabs - доступный и готовый быть выигранным или взятым

to jump-start something - говоря про систему или процесс, которые перестали работать или прогрессировать, сделать что-то, что заставит их начать работать быстро и эффективно

to snare someone or something - получить что-то хитрым способом, возможно обманывая людей

uppity - ведущий себя неприятно, потому что думает, что он важнее, чем он есть на самом деле; наглый

a tungsten / a wolfram - вольфрам

titillating - говоря про сексуальные изображения или описания, умышленно вызывающий возбуждение, но не в серьезной форме

to ease up on someone - обращаться с кем-то менее строго

to lay someone off - прекратить нанимать кого-то, как правило, потому, что им больше нечего делать

to lay off someone or something - прекратить использовать или иметь дело с чем-то, или прекратить критиковать кого-то

to shunt someone or something - 1) переместить кого-то или что-то из одного места в другое, обычно потому, что этот человек или вещь больше не нужны, не учетывая каких-либо неприятных последствий этого
2) шунтировать

accusatory - предполагающий, что вы думаете, что кто-то сделал что-то плохое; обвинительный, обвиняющий

to go back on someone's word - нарушить свое обещание

to lean on someone or something - использовать кого-то или что-то, чтобы помочь вам, особенно в трудной ситуации; опереться

to have/get a stick/pole up your ass about something - грубая фраза, означающая, что вы очень серьезны, легко обижаетесь и всегда хотите, чтобы соблюдались правила

like hell - 1) используется, чтобы подчеркнуть, что вы категорически не согласны или категорически против того, что вам говорят; определенно нет
2) very much

a colon - нижняя и большая половина кишечника, в которой вода удаляется из твердых отходов; толстая кишка

to entertain something - говоря про идею или предложение, позволять себе считать это возможным или достойным серьезного рассмотрения; питать, принимать во внимание

to downplay something - заставить что-то казаться менее важным или менее плохим, чем оно есть на самом деле; преуменьшать

a pestilence - 1) любая очень серьезная инфекционная болезнь, которая быстро распространяется и убивает большое количество людей; мор
2) серьезная и растущая проблема

a heavy hitter - 1) кто-то или что-то очень сильное или успешное
2) человек или компания, которые очень хорошо известны и имеют большое влияние, или очень успешный продукт

to poach on someone's territory/turf - вмешиваться в область, которую обычно контролирует другой человек

to hole up somewhere - оставаться в безопасном месте, часто как способ избежать чего-то или спрятаться от кого-то; затаиться

a buy-in - принятие и готовность активно поддерживать и участвовать в чем-то (например, в предлагаемом новом плане или политике)

uptight - обеспокоеный или нервничающий и неспособный расслабиться; встревоженный

an uptight ass - человек, который, встревожен, властен, социально неуклюж и думает, что может переступить через вас

to hold someone off - остановить кого-то от нападения или победы над вами; сдерживать

a vantage point - место, особенно высокое, с которого открывается хороший, четкий обзор местности

tainted - поврежденный по качеству, вкусу или стоимости; испорченный

to rappel - спускаться по очень крутому склону, держась за веревку, прикрепленную к вершине склона

a vindicator - человек или предмет, который снимает с кого-то вину, подозрения, сомнения и так далее, или доказывает правоту кого-то с помощью доказательств или аргументов; защитник, поборник

to pulse - двигаться или бить в сильном, регулярном ритме; пульсировать

to keep on track - продолжать в том же духе

to debrief someone - говоря про солдата, дипломата или космонавта, просить дать отчет об операции или задаче, которую он только что завершил; допросить

to sweep someone or something under the rug/carpet - скрыть проблему или попытаться сохранить ее в тайне вместо того, чтобы решать ее; спрятать под ковер

to sideline someone - остановить кого-то, принимающего активное и важное участие в чем-то

to take a stand - выражать свое мнение; занять позицию

to boil something down - сократить информацию, обычно так, чтобы она содержала только самые важные ее части

to be big on something - любить что-то очень сильно

to grease something - намазать что-то жиром или маслом

a capacitance - электрическая емкость

a pellet - мелкий металлический предмет, которым стреляют из некоторых видов оружия; пулька, дробинка

an enamel - эмаль

a mattock - мотыга

a tour of duty - период времени, когда солдат выполняет определенную обязанность или находится в определенном месте, например в зоне боевых действий

to shake someone down - получить деньги от кого-то, используя угрозы или уловки; стрясти денег

a politicking - деятельность, направленная на то, чтобы убедить или даже заставить других голосовать за определенную политическую партию или кандидата; политиканство

to steer clear of someone/something - избегать кого-то или что-то, что кажется неприятным, опасным или может вызвать проблемы; держаться подальше

murky - используется для описания сложной и неприятной ситуации, в которой многие факты неясны; темный, мутный

to endorse someone or something - говорить публично, что вы поддерживаете или одобряете кого-то или что-то

an amalgam - амальгама

an egomaniac - кто-то, кто думает только о себе и не заботится о том, причиняют ли они вред другим людям, чтобы получить то, что они хотят

to pry something off something - снять что-то с какой-либо поверхности силой рычага; оторвать что-то от чего-то

to resight something - 1) снова увидеть или увидеть кого-то или что-то
2) снова прицелиться во что-то с помощью прицела

a sludge - мягкая, влажная почва или вещество, похожее на это; ил

a mook - глупый, ничтожный или презренный человек

ulterior - говоря про мотив, причина, цель и так далее, скрытый, тайный

unaccounted for - пропавший без вести

irreparable - непоправимый

a fortitude - храбрость при борьбе с болью или трудностями, особенно в течение длительного периода; стойкость, сила духа

a conspiracy - деятельность по тайному планированию с другими людьми чего-то плохого или незаконного; заговор, сговор

to be convicted on a single count of conspiracy - быть признанным виновным по одному пункту обвинения в заговоре

under the tutelage of someone - под опекой, руководством или советом кого-то

a con artist - человек, который обманывает других людей, заставляя их поверить во что-то ложное или заставляя их раздавать деньги; мошенник

at mission-end - в конце миссии

a brainchild - оригинальная идея, план или изобретение; детище

to trumpet something - объявлять или рассказывать о чем-то с гордостью большому количеству людей

a spouse - супруг или супруга

an infamy - качество известности чем-то, что считается плохим; дурная слава

to rally someone to/behind/for/in favour of/against someone or something - заставить собраться вместе, чтобы оказать поддержку или предпринять совместные усилия; сплотить

to have oversight of something - говоря про процесс или систему, осуществлять надзор

a coup - неожиданно успешное достижение

a pretense / a pretence - 1) заявление, сделанное или подразумеваемое, особенно такое, которое не подтверждается фактами
2) простая показуха, претенциозность или претенциозный поступок или утверждение 
3) неадекватная или неискренняя попытка достичь определенного состояния или качества; претензия
4) заявленное, а не реальное намерение или цель; предлог
5) вымысел
6) фальшивое шоу, симуляция; притворство

without even a pretense/pretence of something - даже без намека на что-то

an economy of scale - эффект масштаба

a print/publishing run - количество экземпляров конкретной книги, газеты и так далее, выпущенных за один раз; тираж

speciality/specialty - разработанный для определенной цели; специальный

a determinant of something - что-то, что заставляет что-то другое быть определенного вида или происходить определенным образом; детерминант, определитель, фактор

an exterior - внешняя часть чего-то или кого-то

a porthole - иллюминатор

to run something - говоря про что что-то длинное, например, дорогу, идти в определенном направлении; туняться вдоль чего-то, идти по чему-то, занимать пространство чего-то

apiece - each

a salvo - одновременная стрельба из нескольких орудий (обычно из больших, таких как артиллерия), будь то во время войны или церемонии; залп

to suspend something - остановить что-то от активности, временно или постоянно; приостановить

a rattle - тряска ???

an antihistamine - тип препарата, который используется для лечения заболеваний, вызванных резкой реакцией на определенные вещества; антигистаминный препарат

to resort to something - делать что-то, чего вы не хотите делать, потому что вы не можете найти другого способа добиться чего-то; прибегать к чему-то

a clear-cutting - удаление всех деревьев на участке леса; вырубка леса

rural - имеющий черты, которые типичны для районов, удаленных от больших городов; сельский

lax - недостаточно заботящийся и недостаточно строгий в соблюдении высоких стандартов; слабый

a carrying capacity - емкость среды

to (far) outstrip someone or something - быть или стать больше по количеству, степени или успеху, чем кто-то или что-то; превышать, превосходить

a payroll - 1) список людей, нанятых компанией, с указанием того, сколько каждый из них зарабатывает; платежная ведомость
2) общая сумма денег, выплачиваемая людям, нанятым конкретной компанией; начисление заработной платы

a blaze - большой пожар, который трудно контролировать и который уничтожает множество вещей

to chase ghosts - искать что-то и бежать за чем-то, чего не существует или, возможно, не произошло

to loosen up - стать более расслабленным и менее напряженным

feigned - притворный, симулированный

a sore - болезненный участок на поверхности тела, особенно инфицированный участок; язва

to succumb to something - говоря про болезни, быть затронутым этим или умирать от этого; поддаваться

to claw someone's way (somewhere) - двигаться вперед с трудом, особенно с помощью жестких изогнутых пальцев, чтобы убрать предметы, стоящие на вашем пути

an extortion - вымогательство

to crop up - произойти или появиться неожиданно

to contract something - говоря про болезни, подхватить или заболеть

to make a fast/quick buck - быстро и легко зарабатать много денег, часто делая то, что считается нечестным

to scope someone or something out - посмотреть внимательно, чтобы увидеть, интересен ли кто-то или что-то

a cipoxidin - ципоксидин (выдуманный препарат) ???

a malanarin - маланарин (выдуманный препарат) ???

a cramp - внезапная сильная боль, вызванная внезапным сокращением мышцы; судорога

a butemerol - бутемерол (выдуманный препарат) ???

a cenozine - ценозин (выдуманный препарат) ???

a genetic marker - ДНК-маркер

a heplacore - геплакор (выдуманный препарат) ???

a demozane - демозан (выдуманный препарат) ???

feasible - достижимый

a carnifex - мясник или палач (латинский)

a henchman - кто-то, кто делает неприятные или незаконные вещи для влиятельного человека; прихвостень

an alcove - альков

a leverage - сила влиять на людей и получать желаемые результаты; рычаг воздействия

to spec something - планировать, делать или сделать что-то в соответствии с определенной спецификацией

to call someone in - попросить кого-нибудь прийти на помощь в трудной ситуации

clandestine - запланированное или сделанное тайно, особенно говоря про что-то, что официально не разрешено или не законно

a wetwork / a wet-work - мокрое дело

a chest-thumping / a chest-pounding - поведение, особенно со стороны мужчины, которое призвано показать, насколько он силен и могущественен

knock it off - используется, чтобы сказать кому-то прекратить делать что-то, что вас раздражает

a padding - ненужные слова или информация, добавленные к речи или тексту

to cause/give someone grief - раздражать кого-то или создавать проблемы для них

to let someone's hair down - расслабиться и получать удовольствие, не беспокоясь о том, чтобы вести себя вежливо

a bugger - грубое слово для обозначения человека, который сделал что-то раздражающее или глупое

an adage - то, что люди часто говорят и что выражает общую истину о каком-то аспекте жизни; мудрое изречение

a mammal - млекопитающее

a neoblast - любая крупная и недифференцированная стволовая клетка некоторых червей, особенно планарий, участвующая в регенерации и восстановлении

differentiated - дифференцированный

a planarian - планарий

to alleviate something - сделать что-то плохое, такое как боль или проблемы, менее серьезными; облегчить, смягчить

somatic - соматический

an overhaul - полное изменение системы, чтобы она работала более эффективно; перестройка, пересмотр

to dismiss someone or something as someone or something - решить, что кто-то или что-то не важны и не заслуживают внимания; отвергнуть как

a travel advisory - официальное объявление, содержащее совет, информацию или предупреждение о путешествии в какое-либо место или через него; рекомендации по путешествиям

a garbage scow - мусорка ???

at the turn of the century - на рубеже веков

to round something out - завершать что-то

per capita - на душу населения

an off-worlder / an offworlder - тот, кто не из локального мира (будь то измерение, планета или вселенная); инопланетянин

covus - ???

defunct - больше несуществующий, неживущий и неработающий правильно

a solar array - массив солнечных батарей

a nice touch - незначительное, но приятное дополнение к чему-то

to ring a bell (with someone) - звучать знакомо для кого-то

unfeeling - не испытывая сочувствия к чужому страданию; бесчувственный

to coddle someone - относиться к кому-то слишком хорошо или слишком сильно кого-то защищать; нянчиться, баловать

a teat - часть тела самки млекопитающего, через которую к ее детям поступает молоко; сосок

a blank slate - 1) кто-то или что-то, что все еще находится в исходном состоянии и еще не изменено людьми, опытом и так далее; чистый лист
2) то, что ничего не показывает и не выражает

weak-willed - неимеющий решимости, необходимой для продолжения трудных действий; безвольный

a retrovirus - ретровирус

to keep something to oneself - никому не рассказывать о чем-то; держать при себе

to keep to oneself - часто избегать других людей; держалаться особняком

a hold - говоря про корабль или самолет, место, где хранится груз или багаж; трюм

an undergraduate - студент, который учится на свою первую степень в колледже или университете; бакалавриат

an outlier - человек, вещь или факт, который сильно отличается от других людей, вещей или фактов, так что его нельзя использовать для выводов общего характера; исключение

outright - полностью или сразу

on a sour note - неприятным образом; на горькой ноте

to bust/crack/bash someone's head/skull (wide) open - получить травму головы от какого-то удара; вскрыть голову

gravimetric - гравиметрический

a coefficient - коэффициент

buoyant - способный или склонный оставаться на плаву или подниматься на поверхность жидкости или газа

to throw off something - 1) излучать или испускать что-то; выбрасывать
2) зарабатывать или генерировать что-то; выдавать

anterior - расположенный спереди или ближе к нему; передний

an intake - отверстие, через которое всасывается воздух, жидкость или газ

a cognition - психический процесс, связанный с знанием, изучением и пониманием вещей; познание, познавательная способность

barring something - за исключением или исключая что-то

tertiary - третичный

where applicable - где применимо

to pit someone or something against someone or something - заставить кого-то или что-то бороться или конкурировать с другим человеком или вещью

a guesswork - процесс предположения, когда вы не знаете всех фактов; догадка

the reins / the reins of power - бразды правления

astronautical - относящийся к космонавтике или астронавтам

planetward - в сторону планеты

a sea/shipping lane - судоходный путь

abundant - более, чем достаточный; обильный

an extremophile - экстремофил

geophagous - питающийся почвой

a deposition - образование слоя вещества, такого как почва или горная порода, или слой, который образуется; отложение, оседание

an impurity - вещество, которое в небольших количествах присутствует в другом веществе и делает его грязным или неприемлемым по качеству; примесь

a sheen - блеск, возникающий из-за отраженного света

to hobble someone or something - мешать кому-то или чему-то добиться успеха или добиться того, чего они хотят; сковывать

to be in the grip of something - испытывать что-то неприятное, что вы не можете контролировать; быть во власти или тисках чего-то

to gnash - быстро сблизить верхние и нижние зубы; скрежетать зубами

to exhibit something - показать что-то, особенно какое-то качество вашим поведением; проявлять

to heighten something - увеличить или заставить что-то увеличиться, особенно эмоцию или эффект; усилить

to be afflicted by something - говоря про боли, болезни или несчастья, быть под плохим влиянием от чего-то и страдать от этого

within living memory - в памяти живых

an imaging - процесс создания точной картины чего-то, особенно на экране компьютера; визуализация

multistatic - содержащий несколько статических радарных блоков

an elevation - участок земли, который выше, чем область вокруг него; возвышение

warranted by something - оправданный или обусловленный чем-то

to resolve something - сделать что-то ясно видимым

a cross-section - поперечное сечение

a fact of life - что-то неприятное, чего нельзя избежать; правда жизни

a setback - событие, которое задерживает ваш прогресс или обращает вспять часть достигнутого вами прогресса; неудача

a purgatory - чистилище

an ark - ковчег

unscrupulous - ведущий себя нечестно или несправедливо, чтобы получить желаемое; недобросовестный

to abound - существовать в большом количестве; изобиловать

a sabot - облегченная выпадающая после выстрела гильза, в которую заключен подкалиберный патрон, чтобы он подходил к нарезам огнестрельного оружия

a jacket - внешнее покрытие или кожух, такой как прочный холоднодеформированный металлический кожух, который образует внешнюю оболочку составной пули

to mass - собираться в большом количестве

a tinge - очень небольшое количество цвета или чувства; оттенок

to scare something up - найти или получить что-то, несмотря на трудности или ограниченные запасы

a squatter - человек, который живет в пустом здании без разрешения; скваттер

a silicate - силикат

cursorily - быстро и не очень осторожно; бегло

to circularize something - сделать что-то широко известным

a nautilus - наутилус

an avalanche - лавина

a superfluid - необычное состояние вещества, наблюдаемое только в жидком гелии, охлажденном почти до абсолютного нуля и характеризующееся, по-видимому, течением без трения (как через тонкие отверстия); сверхтекучесть

to deface something - повредить и испортить внешний вид чего-то, написав или нарисовав на этом

At the other extreme, ... - С другой стороны, ...

a blood vessel - кровеносный сосуд

to constrict - сужаться

to relinquish something - невольно прекратить держать или удерживать что-то

to out-process - закончить военную командировку, сопроводив необходимыми документами

on a moment's/minute's notice - сразу после того, как о чем-то было сообщено

supermax - имеющий или относящийся к очень высоким уровням безопасности

a con - a convict

to thaw - переходить из твердого, замороженного состояния в жидкое или мягкое из-за повышения температуры; оттаивать

a cellblock - группа камер, составляющая часть тюрьмы

two-bit - стоящий очень мало или не очень важный

to strike gold - получить большую прибыль или стать богатым

to make something/it worth someone's while - заплатить кому-то, чтобы сделать что-то

straight up / straight-up - честный, прямой

dental - относящийся к зубам или к уходу и лечению зубов

a furlough - период времени, в течение которого солдату, рабочему или заключенному разрешается отсутствовать, особенно для временного возвращения в свой дом; отпуск

to get/take a rise out of someone - раздражать кого-то

to press/push someone's buttons - вызвать сильную реакцию или эмоцию у кого-то

to be on/at the receiving end of something - страдать из-за чего-то неприятного, сделанного кем-то

a distress - чувство крайнего беспокойства, печали или боли

(it is) about time ... - используется, чтобы эмфатически сказать, что что-то должно произойти или быть сделано сейчас, а на самом деле должно было произойти или быть сделано раньше; пришло время что-то сделать

to pull something off - преуспеть в выполнении чего-то сложного или неожиданного

to buckle (under something) - уступить или потерпеть поражение в трудной ситуации

a power draw - потребляемая мощность

wicked - настолько исключительного качества или степени, что выходит за разумные или предсказуемые пределы

to live up to something - достичь ожидаемого, особенно высоких стандартов

a powerhouse - страна, организация или человек с большим влиянием, властью или энергией

to be out to do something/for something - делать что-то или намереваться что-то сделать по неприятной причине или только потому, что это хорошо для вас, а не для других

a media outlet - СМИ

a cost overrun - перерасход средств

a country's own backyard - собственная территория какой-то страный или что-то очень близкое, где эта страна хочет влиять на события

to bent on something - быть очень решительными, чтобы сделать что-то

a jailbreak - побег из тюрьмы

an outreach programme/ program - программа, предназначенная для помощи и поощрения обездоленных членов сообщества

to take something up with someone - начать обсуждение какой-то темы с кем-то

a safe house / a safehouse - жилище или здание, скромный вид которого делает его неприметным местом, где можно спрятаться, укрыться или заниматься тайной деятельностью

a rep - a representative

to rectify something - говоря про что-то неправильное, сделать правильным или удовлетворительным; исправить

to leave someone or something behind - уйти от кого-то или чего-то навсегда; бросить

to leave something behind - говоря про объект или ситуацию, оставить после того, как вы покинули место; оставить после себя

to be left behind - говоря про человека, страну или организацию, оставаться на более низком уровне, чем другие, потому что они не так быстро понимают вещи или развиваются; оставаться позади

to get over something - принять неприятный факт или ситуацию, поработав с ней какое-то время

a fat chance (of something) - используется, чтобы сказать, что вы не думаете, что что-то может случиться

an order of magnitude - приблизительное представление о количестве или важности чего-то; порядок величины

a firmware - встроенное программное обеспечение

toe-to-toe - прямо противостовляя или конкурируя друг с другом

sated with something - быть сытым чем-то

to chase someone off - прогонять кого-то

to ping - отправить электронное письмо, текстовое или другое сообщение, особенно на чей-то мобильный телефон

to tick over - говоря про бизнес или систему, продолжать работать, но не расти и не достигать большого прогресса; дотикивать

a holding - что-то, чем вы владеете, например акции компании или здания, или земля, которую вы арендуете и обрабатываете

to own up yo something - признать, что вы сделали что-то не так

to wax nostalgic - подробно говорить о своих чувствах ностальгии, как правило, таким образом, что это утомляет других

to shadow someone - следовать за кем-то очень внимательно, куда бы они не пошли

to slosh around - проливать или брызгать обильно или неуклюже; плескаться

to check something out - изучить что-то или получить дополнительную информацию об этом, чтобы убедиться, что это правда, безопасно или подходит вам

a joyriding / a joy-riding - быстрое и опасное вождение для удовольствия, особенно в угнанном автомобиле

an ace in the hole - преимущество, которое у вас есть над противником или соперником и которое вы можете использовать в случае необходимости; туз или козырь в рукаве

an arson - преступление умышленного разжигания огня с целью повреждения или разрушения чего-то, особенно здания; поджог

to tie in with something - говоря про идею или факт, согласовываться или быть связанным с чем-то

estranged from someone - говоря про свою семью или друзей, серьезно поссорившийся с ними и больше недружащий с ними; отчужденный, разобщенный

a praetor - любой из нескольких старших магистратов рангом чуть ниже консулов в Древнем Риме; претор

praetorian - имеющий отношение к претору

a praetorian - лицо, имеющее преторианское звание; претор или бывший претор, преторианец

to denature something - изменять или разрушать природную структуру молекулы белка, нуклеиновой кислоты и других биополимеров; денатуировать

a pus - густая желтоватая жидкость, которая образуется в результате инфицированного пореза или травмы тела; гной

an inhalation - действие по вдыханию воздуха, дыма или газа в легкие

proper - может добавляться после слова, чтобы указать, что вы имеете в виду центральную и наиболее важную часть места, события или объекта и хотите отличить его от других вещей, которые не считаются важными или центральными по отношению к нему; самому чему-то; собствено что-то

a refuge - место, дающее защиту или убежище от опасности, беды, несчастья и так далее; убежище

a fringe-dweller / a fringe dweller - абориген в Австралии, проживающий на окраине города или другого поселения, из которых они были исключены, как правило, в результате закона или отчуждения земли в результате колонизации

a compensator - любое из различных устройств или цепей, используемых для исправления или компенсации некоторых воздействий, таких как отклонения скорости в движущейся системе или чрезмерный ток в цепи; компенсатор

to liken someone or something to someone or something - сказать, что кто-то или что-то похоже на кого-то или что-то или имеет те же качества, что и кто-то или что-то другое

a cerebellum - мозжечок

a scion - молодой член богатой и знаменитой семьи

ghastly - неприятный и шокирующий; ужасный

a frame - телосложение

to be overlaid with something - быть покрытым чем-то

a resin - смола

a rebreather - изолирующий дыхательный аппарат; ребризер

SNAFU - Situation normal: all fucked up

to take something in (someone's) stride - относиться к проблеме или трудности спокойно и не позволять им влиять на то, что вы делаете; спокойно относиться

indentured - относящийся к соглашению, по которому кто-то работает на кого-то другого до тех пор, пока он не выплатит долг, особенно в прошлом, когда бедняки работали на кого-то в другой стране в обмен на то, что их перевезли в эту страну; связанный договором

to perch in/on/etc. something - сидеть на краю чего-то или рядом с этим

devoid of something - не иметь или быть без чего-то необходимого или обычного; лишен чего-то

palatable - приятный на вкус

a crop - такие растения, как пшеница и картофель, которые выращивают в больших количествах для еды; культура

a portfolio - совокупность акций компании и других инвестиций, принадлежащих конкретному лицу или организации; портфель

a primordial soup/goo - первичный бульон

a troposphere - тропосфера

prematurely - преждевременно

to erupt into something - резко перерасти в новую ситуацию или проблему; перерасти во что-то (например, в серьезный конфликт)

tantamount to something - почти такой же или имеющий тот же эффект, что и что-то, обычно что-то плохое; равносильный чему-то

to brave someone or something - справиться с неприятной или сложной ситуацией

to be averse to something - быть категорически против чего-то или сильно не любить что-то

to huddle up - приблизить конечности к туловищу; свернуться

to clamp down on something - принять решительные меры, чтобы остановить или ограничить вредную или нежелательную деятельность

a perch - 1) короткий стержень, на котором птица может стоять
2) сиденье или другое место наверху, откуда часто хорошо видно что-то внизу

to whittle something down - постепенно уменьшать размер чего-то или количество людей в группе

a sine curve - синусоида

peachy (keen) - очень хороший

to oscillate - многократно переходить из одной позиции в другую; колебаться

uplifting - заставляющий вас чувствовать себя очень радостным и счастливым; воодушевляющий

to derail something - предотвратить план или процесс от успеха; сорвать

a leeway - 1) свобода действий в определенных пределах
2) количество или период времени, которые были потеряны или потрачены впустую
3) дополнительное время или деньги

foolhardy - смелый по-глупому, идущий на ненужный риск; безрассудный

a volley - большое количество пуль выпущенных одновременно (обычно из небольших типов оружия, таких как винтовки или ружья); залп

a conditioning - процесс дрессировки или психологического воздействия на человека или животное, чтобы они делали или ожидали определенного действия, не задумываясь об этом; обработка, обусловленность

to trail someone or something - следовать за кем-то или чем-то тайно, часто находя следы или знаки, которые они оставили; выслеживать

an entryman - 1) тот, кто вступает на государственную землю с намерением получить участок в соответствии с законами о приусадебных, горных работах или другими законами
2) шахтер, занятый вождением откатки, воздуховода или прохода

a hank of something - толстый кусок или пучок волос, ниток, веревки и так далее

to eyeball someone or something - пялиться на кого-то или что-то

apparent - явный и очевидный для кого-то

to bolster something - поддержать что-то или сделать что-то сильнее

en route - в пути куда-то

an inquiry - 1) процесс расспросов или исследования чего-либо с целью узнать об этом больше
2) официальное расследование

a candlelight vigil - бдение при свечах или служба при свечах

a reverend - титул священника христианской церкви; преподобный

non-denominational / nondenominational - неследующий или неограничивающийся какой-либо конкретной религиозной конфессией

to hassle someone - создавать проблемы или хлопоты для кого-то, часто повторяя кому-то или прося кого-то сделать что-то раздражающим образом

superficial - поверхностный

hard-hit - серьезно пострадавший

to turn someone's nose up at someone or something - отказываться брать или принимать кого-то или что-то, потому что кто-то или что-то недостаточно хорошо; воротить нос

a vat - большая бочка или бак, в котором можно хранить жидкости

a cordon - кордон

a memento - предмет, который вы храните, чтобы помнить человека, место или событие

a classism - классовая дискриминация, классизм

an outlet - магазин, который является одним из многих, принадлежащих определенной компании и который продает товары, произведенные этой компанией; торговая точка

well off - богатый

a rodent - грызун

knowing - показывающий, что знает о чем-то, даже если об этом не говорил; понимающий

festive - имеющий или вызывающий счастливые и приятные чувства, подходящие для фестиваля или другого особого случая; праздничный

intestinal - кишечный

an acuity - острота зрения или слуха, или быстрота мышления

dextrous - праворукий

sinistrous - леворукий

a chirality - хиральность

amino dextrous acid - правая аминокислота

amino sinister acid - левая аминокислота

a connoisseur - человек, который любит и много знает об одном из искусств, видов еды, напитков и так далее, и может судить об этом; знаток, ценитель

cuisine - тип пищи, приготовленной особым образом в зависимости от ингредиентов, региона и традиций той или иной культуры; кухня (например, итальянская)

peerless - настолько прекрасный или чудесный, что вы чувствуете, что ничто не может сравниться с этим; несравненный, бесподобный

a no money down / a no-money-down - способ покупки недвижимости, когда покупатель может приобрести право собственности на недвижимость без первоначального взноса или с минимальным денежным взносом

bulbous - довольно уродливо круглое и толстое

a conveyor - конвейер

a grace - 1) одобрение или доброта, особенно (в христианской религии), которую Бог дарует всем людям; милость
2) молитва, произносимая христианами перед едой, чтобы поблагодарить Бога за еду

comest - comes

morose - несчастный, вспыльчивый и нежелающий много разговаривать с другими людьми; угрюмый

a rumination - акт тщательного и длительного обдумывания чего-то

'tis - it is

nobler - dignified - сдержанный, серьезный и спокойный, а потому заслуживающий уважения; достойный

in the mind - of opinion

a sling - простое оружие, использовавшееся в основном в прошлом, в котором ремешок, закрепленный на концах, использовался для метания камней; рогатка

outrageous - неприемлемый или очень шокирующий; возмутительный

fearful (of something) - испуганный или обеспокоенный чем-то

a wonder - чувство большого удивления и восхищения, вызванное увиденным или испытанным чем-то необычным и новым; удивление

a minister - религиозный лидер в некоторых христианских церквях; служители

in the mind - говоря про что-то вроде болезни, связано с чьими-то чувствами или отношением, а не с какой-либо физической причиной; в голове

a fortune - набор хороших или плохих событий, которые происходят с вами и влияют на вашу жизнь; судьба

addlepated - глупый и запутанный; бестолковый

a turf - газон

to lard something with something - покрыть что-то салом или подобным жиром

to beweep someone or something - плакать над кем-то или чем-то

venomous - полный гнева или ненависти; ядовитый

a faculty - 1) естественная способность слышать, видеть, думать, двигаться и так далее
2) особая способность делать что-то конкретное

express - 1) перемещающийся или отправляющийся быстро; экспресс
2) ясно и намеренно сказанный; явный, явно выраженный

an apprehension (about something) - беспокойство о будущем или страх, что произойдет что-то неприятное; опасение

an apprehension of something - понимание чего-то или способ, которым понимается что-то

a paragon - кто-то, кто совершенен или обладает множеством хороших качеств; образец совершенства

alas - выражение печали или разочарования, особенно когда нет надежды на то, что ситуация изменится; увы

a jest - то, что вы говорите, чтобы позабавить; шутка

a gibe / a jibe - оскорбительное замечание, призванное выставить кого-то глупым

a gambol - беззаботная развлекательная деятельность для развлечения или чтобы отвлечься

a merriment - случай, когда люди смеются или весело проводят время вместе

to be wont to do something - часто или регулярно делать что-то

to roar with something - выражать шумно эмоции, такие как смех или гнев