panting - запыхавшийся, тяжело дышащий

to snuff out something - 1) потушить что-то (например, пожар) 
2) привести к концу что-то; прервать, подавить или уничтожить что-то (например, прервать карьеру)

The Von Braun - Фон Браун

to undertake something - делать или начать что-то делать, особенно то, что займет много времени или будет трудным

a maiden voyage - первое путешествие, совершенное каким-то кораблем; первый рейс или плавание

UNN / Unified National Nominate - Унифицированная Национальная Номинация

a protectorate - протекторат

newly - 1) недавно 
2) снова

a commitment - 1) обещание или твердое решение что-то сделать 
2) обязательство или готовность отдавать свое время и энергию работе, деятельности или чему-то, во что вы верите

wholly owned - полностью принадлежащий кому-то (например, одна фирма поолностью принадлежащая другой)

a subsidiary - филиал, дочерняя компания

to plow through something - пробиваться или продвигаться через что-то медленно и с трудом

The UNN Rickenbacker - Рикенбакер

at something's helm - у руля какого-то транспортного средства

no less than ... - никто иной как ...

a harbor - гавань, порт

a police action - локальная военная акция, предпринятая без официального объявления войны регулярными вооруженными силами против лиц, признанных нарушителями международного мира и порядка

intricate - имеющий множества мелких деталей, которые устроены сложным или деликатным образом; сложный, замысловатый

a piggyback - катание на чьей-то спине, когда ваши руки обвивают шею человека, а ноги обвивают его талию

to piggyback - использовать что-то созданное кем-то другий, чтобы получить какое-то преимущество

sleek - гладкий и блестящий, как будто отполированный

a wonder - чувство удивления, смешанное с восхищением, вызванное чем-то прекрасным, неожиданным, незнакомым или необъяснимым, или объект, вызывающий такое чувство; чудо

a bosom - 1) женская грудь 
2) передняя часть груди человека, особенно если ее рассматривать как центр человеческих чувств; лоно

to hijack something - взять под контроль самолет или другое транспортное средство во время путешествия, особенно с применением насилия

out of order - неработающий по причине поломки

a booth - будка (например, телефонная)

MFD / multi-function display - многофункциональный дисплей

to get the hang of something - получить какие-то навыки или разобраться что надо сделать для чего-то

a weapon kickback - отдача оружия в сторону вашего тела

a weapon recoil - отдача оружия, когда при выстреле уводит в стороны ствол оружия

an affinity - 1) симпатия к кому-то или чему-то, особенно из-за общих характеристик; близость, влечение 
2) близкое сходство между двумя вещами; сродство

a dampening - демпфирование

psionic - псионический

psychogenic - психогенный

a cryokinesis - криокинез

to tamper with someone or something - 1) вмешиваться, трогать или вносить изменения в то, куда это не следует делать, как правило, без достаточных знаний о том, как что-то работает, или когда вы пытаетесь это повредить 
2) говорить и пытаться повлиять на кого-то, кто участвует в судебном деле; вмешиваться

a decontamination - нейтрализация или удаление опасных веществ, радиоактивности или микробов с территории, объекта или человека; обеззараживание, дезактивация, дегазация

a pyrokinesis - пирокинез

a hypnogenesis - гипногенез 

a soma - весь организм, за исключением его репродуктивных клеток

instantaneous - мгновенный

metacreative - метатворческий

a hydrogenated oil - гидрогенизированное масло

a treat - тип пищи, которую едят в дополнение к обычному приему пищи, обычно что-то сладкое; лакомоство

a nutrition - питание

nutritional - питательный

to beat something - многократно перемешивать что-то с помощью такой посуды, как ложка или венчик; взбить что-то (например, еду)

by the bunch - пачками (например, есть чипсы пачками)

gene-grafted - генетически привитый

a hydroponics - гидропоника

caffeinated - содержащий кофеин

chock-full something - чем-то полностью или битком заполненный

a fruit pulp - фруктовая мякоть

deceptively - обманчиво

low-tech - низкотехнологичный

to counterfeit something - сделать что-то похожим на оригинал чего-то другого, обычно в нечестных или незаконных целях; подделать

PDA - Personal Data Assistant

a rig - установка (например, буровая установка)

to put the "sigh" back in something - вдохнуть во-что новую жизнь

arbitrary - основаный на случайности, а не планах или разуме; произвольный, случайный

to mantle onto something - когда карабкаясь наверх, зацепляться за что-то, чтобы опереться на это с целью поднятия тела вверх

a hypo - лекарство, вводимое под кожу
	
an enzyme - любые из группы химических веществ, которые вырабатываются живыми клетками и вызывают определенные химические реакции, но сами не изменяются; фермент, энзим

an assessent - акт суждения или решения о количестве, ценности, качестве или важности чего-то или кого-то, или суждение или решение, которое было принято; оценка, суждение

a makeup - состав чего-то (например, химический состав)

an anticoagulant - антикоагулянт

in a pinch - таким образом, чтобы сделать что-то только если это действительно необходимо, но это будет сложно, неидеально или не то, что вам бы очень хотелось; в крайнем случае; но если необходимо

a vacc needle - a vaccine needle

a litigation - судебные разбирательства или тяжбы; судебный процесс

a legal department - юридический отдел

an eventuality - что-то неприятное или неожиданное, что может произойти или существовать в будущем; неприятная или неожиданная возможность или вероятность

a fermium - фермиум

to be fitted with something - быть оснащенным чем-то

dispensing - говоря про машины или контейнеры, способный поставлять или выдавать продукт или наличные деньги; раздаточный, разливной

a nozzle - сопло

to chip away at something - постепенно уменьшать что-то, чтобы оно становилось меньше или слабее

an ordnance - военные боеприпасы, особенно оружие и бомбы

readily - быстро, сразу, по желанию или без проблем; легко, охотно, быстро, без труда

readily available - легкодоступные

a tight spot - тяжелое положение

to get out of a tight spot - выбраться из тяжелого положения

inordinate - намного большее, чем обычно или чем ожидалось; чрезмерный

a strain - сила или воздействие, которое растягивает, тянет или давит на что-то, иногда вызывая повреждение; нагрузка

a wear and tear - повреждения, которые естественно и неизбежно возникают в результате нормального износа или старения какой-то вещи

disposable - одноразовый и выбрасываемый после использования

to come in handy - пригодиться, принести пользу

Marines - Морские Пехотинцы

Navy - Флот

OSA / Office of Secret Actions - Управление Секретными Делами

an outline - контур

potent - очень мощный, очень сильный или очень эффективный

to relieve something - сделать неприятное чувство, такое как боль или беспокойство, менее сильным; облегчить, развеять

circulatory - имеющий отношение к кровообращению

Black Ops / black operations - тайные военные или политические операции, в ходе которых могут применяться меры, обычно не санкционированные

to inhibit something - замедлить процесс или рост чего-то; подавить, препятствовать, тормозить, сдерживать

inherent in something - присущий или свойственный чему-то, характерный или неотъемлемый для чего-то

to proscribe something - официально запретить что-то

utilitarian - утилитарный

axes - plural form of axis

a posting - работа, часто в той же организации, в которой вы работаете, которая предполагает поездку в другую страну или город; командировка

to pressurize - удерживать содержимое под давлением, превышающим давление внешней атмосферы, особенно для поддержания близкого к нормальному атмосферного давления во время высотного или космического полета

a tour of duty - период времени, который кто-то, особенно военнослужащий или чиновник, проводит на работе в чужой стране; дежурство, наряд, стажировка, пребывание в должности

rowdy - шумный и возможно буйный

a tussle - 1) сложное разногласие, жестокий спор или борьба, обычно для того, чтобы что-то получить или достичь
2) драка с другим человеком руками и телом

an engineer's mate - помощник инженера

to learn / know your way around something - стать или быть хорошо знакомым с местом, предметом или системой и, следовательно, быть в состоянии пользоваться этим эффективно

to get someone's feet wet with something - начать выполнять новую работу, деятельность и так далее, обычно медленным и простым способом, чтобы лучше познакомиться с чем-то

to conclude something - привести что-то к концу

a ensign - морской офицер низшего ранга

to ferry someone or something - перевозить людей или грузы в транспортном средстве, особенно регулярно и часто

an navigator's mate - помощник штурмана

to limp - 1) хромать
2) двигаться или перемещаться медленно и с трудом

to suffice - быть достаточным для чего-то (например, этих денег будет достаточно)

odds and ends of something - разные вещи разного типа, обычно мелкие и не важные, или малоценные; всякая всячина

when (the) shit/crap hits the fan - когда какая-то ситуация внезапно принесла массу неприятностей

to steady oneself - снова обреcти равновесие, чтобы не упасть (потерять равновесие можно также по какой-то не физической причине, например от шокирующей новости)

for the time being - в данный момент

pressing - говоря про задачи или проблемы, требующие быстрых или немедленных действий или внимания; неотложный, насущный

a wrench - гаечный ключ

makeshift - временный и некачественный, но используемый из-за внезапной необходимости; самодельный и импровизированный

to annotate - добавить краткое объяснение или мнение к тексту или изображению

a breakage - что-то, что сломалось; факт того, что что-то сломано; поломка

to confer something - дать честь, официальное звание или способность кому-то; даровать, присуждать

to careen - двигаться быстро вперед, двигаясь из стороны в сторону

to circumvent something - увернуться от чего-то, особенно ловко или незаконно; избежать, обойти

to insulate something against something - покрыть и окружить что-то материалом или веществом, чтобы предотвратить утечку или проникновение тепла, звука или электричества; изолировать

a beverage - напиток

semipermeable - полупроницаемый

a rim - внешний, часто изогнутый или круглый край чего-то; обод, край, оправа

a bulkhead - стена, разделяющая внутреннюю часть корабля или самолета; переборка, перегородка

an alcohol proof - единица измерения крепости напитков в англоязычных странах; пруф

a rotgut - дешевый или некачественный алкоголь; ядовитое пойло

notably - в особенности, особенно

excess - больше, чем необходимо, или слишком много; избыточный, сверх нормы или нужды

an agent - человек или предмет, который производит определенный эффект или вызывает какое-то изменение; химическое вещество, организм или природная сила, которые своим действием производят определенный эффект; средство (например, чистящее средства)

hardy - говоря про растения, способные пережить зиму без защиты от непогоды; морозоустойчивый, выносливый

striking - очень необычный или легко заметный, а потому привлекающий много внимания; поразительный

to be reduced to something - быть вынужденным сделать то, что вы бы не предпочли делать, особенно когда это связано с поведением или образом жизни, который не так хорош, как раньше

to bring something down - уменьшить уровень или количество чего-то

an armful of something - количество чего-то, которое человек может унести в одной или обеих руках; охапка

to call up someone - приказать кому-то присоединиться к вооруженным силам или принять участие в военной операции

la-di-da / la-de-da / lah-de-dah / lah-dee-dah / lah-di-dah - притворно или претенциозно элегантный или утонченный в манерах или вкусах

discretely - таким образом, который четко отделяет что-то от остальных частей; отдельно и индивидуально (например, каждый школьный предмет можно рассматривать отдельно)

a quantum entanglement - квантовая запутанность

a decomposition - разложение, гниение

insipid - не обладающий сильным вкусом или характером, или не имеющий интереса или энергии; пресный, безжизненный, безвкусный, вялый

numbingly - ошеломляющим или парализующим образом

to short out something - повредить или вывести из строя электронное устройство в результате короткого замыкания

to botch something - испортить что-то, выполняя плохо какое-то действие

an emanation - эманация

to get going - начать путешствие, пойти куда-то или начать делать что-то, особенно после промедления

a grunt - солдат низкого ранга

a display - демонстрация своих чувств каким-то образом; проявление

Lazarus - Лазарь из Вифании

a discarding sabot round - подкалиберный боеприпас

a tip - обычно заостренный конец чего-то, особенно чего-то длинного и тонкого; наконечник

a casing - контейнер или крышка, которая окружает что-то, чтобы скрепить или защитить это что-то; кожух, оболочка, обшивка

to line something with something - покрыть внутреннюю поверхность чего-то чем-то; облицевать

a drag - сила, препятствующая движению тел в жидкостях и газах; лобовое сопротивление

to impart something to something - придать особое ощущение, качество или вкус чему-то

tumorous - относящийся к опухоли или напоминающий опухоль; опухолевидный

a spinal column - позвоночник

a brain stem - мозговой ствол

a tissue - группа соединенных клеток животного или растения, сходных между собой, имеющих одинаковое назначение и образующих указанную часть животного или растения; ткань

glandular - принадлежащий или относящийся к железе или железам, произведенный или вызванный ими; железистый, грандулярный

irrevocable - невозможный для обратного изменения, необратимый

a stimulus - то, что вызывает реакцию частей тела; стимул, раздражитель

a vivisection - использование живых животных в тестах, которые предназначены для расширения знаний человека о болезнях человека и последствиях использования определенных лекарств; вивисекция

residual - оставшийся после того, как большая часть чего-то была удалена или вычтена; остаточный

every so often - время от времени

novel - новый и оригинальный, не похожий ни на что виденное ранее

inflammatory - вызывающий или связанный с отеком и болью в теле; воспалительный

to beat the hell out of someone - атаковать человека физическими ударами так, чтобы он получил серьезные травмы; эту фразу можно использовать как буквально, так и гиперболически

to assure someone that ... - пообещать или сказать что-то кому-то уверенно или твердо, или вызывать у кого-то уверенность, устраняя сомнения; уверять, что ...

to sign something to someone - отдать приказ, передать информацию или сделать запрос кому-то, используя движения рук и тела; сделать знак

single-handedly - без помощи кого-то другого, в одиночку

to trump someone or something - быть лучше или иметь большее значение или силу, чем другой человек или вещь; превзойти кого-то или чего-то

an animal behaviorist - специалист по поведению животных

planetside - на или к планете

a joint venture - бизнес или бизнес-деятельность, над которой два или более человека или компании работают вместе; совместное предприятие

a land grant - отвод земельного участка

to frag someone - уничтожить кого-то осколочной гранатой

eclectic - эклектический

a staple - базовый продукт питания, основной продукт или основной материал

a sampling - действие или процесс взятия образцов чего-то для анализа

a displacement - занятие погруженным телом объема жидкости, который в противном случае был бы занят этой жидкостью; вытеснение

pinpoint - абсолютно точный, прицельный

a vicinity - область, непосредственно окружающая что-то

in the close vicinity of someone or something - в непосредственной близости от кого-то или чего-то

a goodwill team - команда доброй воли

phylo- - приставка, комбинирющая значения «раса», «племя», «род»

an additive - вещество, добавляемое в пищу для улучшения ее вкуса или внешнего вида или для сохранения ее свежести и предотвращения гниения; добавка

to infuse something with something - настаивать напиток или что-то другое чем-то, чтобы добавить аромат

a tar - одно из ядовитых веществ, содержащихся в табаке; смола

a carbon - углерод

to deposit something - оставить что-то где-то; отложить, высадить

to yank someone's chain - дразнить кого-то, часто пытаясь убедить его в чем-то, что не соответствует действительности

to get down to brass tacks - перейти к деталям, имеющим непосредственное практическое значение; перейти к делу

to swim with sharks - быть связанным с хитрыми, возможно, опасными людьми

a incision - надрез, разрез

an airlock - помещение между двумя областями с разным давлением воздуха, позволяющее переходить из одной области в другую; шлюз

in place - существующий или пригодный для использования в каком-то месте

invasive - инвазивный

a fluidics - флюидика

to conceive of something - воображать или представлять что-то

to wallow in self pity - преувилечивая жалеть себя; валяться в жалости к себе

tenuous - говоря про связь между чем-то, какой-то идее или ситуации, тонкий, слабый, легколомающийся и маловероятный, что существует

as of late - как в последнее время

to get to the bottom of something - добраться до сути чего-то

to go beyond any imaginings of someone or something - выходить за рамки любого воображения кого-то или чего-то

to guard/protect someone or something jealously - защищать что-то очень тщательно, потому что это очень важно для вас; ревносто, тщательно

to get/take a grip on oneself - постараться контролировать свои эмоции и вести себя спокойнее; собраться

acutely - говоря про описание интеллекта, чувств и так далее, очень хороший, точный и способный замечать очень небольшие различия и детали; острый

a remainder of something - остаток чего-то

to lash out with something - внезапно атаковать кого-то или что-то чем-то или гневно критиковать; наброситься

to dampen someone or something - 1) сделать чьи-та чувства, особенно волнение или удовольствие, менее сильными; ослабить, утихомирить 
2) сделать что-то менее сильным или успешным; ослабить, снизить

an electric prod - электрическое устройство, обычно используемое для того, чтобы заставить крупный рогатый скот или другой домашний скот двигаться, ударяя или тыча им

I mean it - фраза, чтобы сказать, что вы серьезны по поводу чего-то или говорите правду касательно чего-то; Я серьезно!

to hang tight - подождать, прежде чем что-то делать

a jarhead - морпех

for love or money - обычно используется в отрицании, ни за что угодно

to get/take the hint - понять, что кто-то предлагает что-то, когда он или она говорит что-то косвенным образом

all of sudden - быстро и неожиданно

to return something - ответить на чей-то вопрос или просьбу (например, ответить на мое электронное письмо)

a mesh - материал, подобный сетке с промежутками в ней, сделанный из проволоки, пластика или нити

a kevlar - кевлар

a substrate - нижележащее вещество или слой; подложка

marginally - в ограниченной степени, слегка

a belligerent - страна, группа или человек, которые ведут войну; воюющая сторона

a beaker - стеклянный или пластиковый контейнер, используемый в химии; лабораторный или химический стакан

a clipping - какой-то кусочек или обрезок, который был отрезан от чего-то

a infusion - добавление одной вещи к другой, чтобы сделать ее сильнее или лучше; вливание

haphazard - не имеющий порядка, цели; созданный без плана; бессистемный

jury-rig - говоря про устройства или машины, собранный, починенный, расположенный или смонтированный импровизированно, из подручного материала и, скорее всего, временно

to be down to something - иметь что-то в количестве, сокращенном до минимума

a smear - грязный след, полученный путем нанесения жидкости или густого вещества на поверхность; мазок, пятно

a junction - интерфейс в полупроводниковом приборе между областями с различными электрическими характеристиками; соединение, узел

to graft - встроиться в качестве трасплантата, прижиться (например, кожа приживается при пересадке с одного участка тела на другой)

to take on something - начать иметь, использовать или делать что-то; приобретать, принимать (например, хамелеон принимает цвета своего окружения)

an annelid - кольчатый червь

a pod - длинный узкий контейнер, прикрепленный к воздушному судну для содержания внутри себя двигателей, оружия, дополнительного топлива и так далее

a nacelle - отсек летательного аппарата (как правило обтекаемой формы), предназначенный для монтажа двигателя и выступающий за пределы фюзеляжа или крыла, на котором установлен двигатель; мотогондола; мотогондолой может называться также гондола аэростата, в которой установлены двигатели

to have/keep an/someone's eye out for someone or something - тщательно или бдительно искать кого-то или что-то

to convey something - 1) выразить мысль, чувство или идею так, чтобы ее поняли другие люди; передать (например, передайте соболезнования семье) 
2) взять или отнести кого-то или что-то в определенное место; передавать, переправлять, транспортировать

a spook - шпион

to break someone's stride - остановить или замедлять чье-то движение

porous - пористый, губчатый

a shaft - шест или стержень, образующий рукоять инструмента или оружия

to give it to someone (good / but good) for something - 1) упрекать или ругать кого-то за что-то; словесно или физически наказать кого-то за что-то; надавать кому-то (хорошенько) 
2) действовать словесно или физически по отношению к кому-то с применением силы

to give it to someone straight - сказать что-то кому-то ясно и прямо

to give it to someone - признать, что кто-то проделал хорошую работу; отдать должное

the clowns are running the circus - фраза, чтобы показать, что в организации или компании делами правит не босс, а рядовые сотрудники

to plug up something - засорять, забивать или закупоривать что-то собой (например, волосы забили канализацию)

to prove + adjective - показать по прошествии времени или на собственном опыте, что что-то или кто-то обладает определенным качеством

compelled to do something - вынужденный сделать что-то

principally - главным образом, преимущественно

glossy - глянцевый

an accoutrement - аксессуар к одежде или снаряжению

communal - принадлежащий или используемый группой людей, а не одним человеком; коммунальный, общественный, коллективный

airborne - находящийся в воздухе, переносимый по воздуху, ветру или самолетом

afloat - на плаву

to stay/keep something afloat - держаться или держать что-то на плаву

despicable - очень неприятный или плохой, вызывающий сильное чувство неприязни; презренный

to nurture - заботиться, кормить и защищать кого-то или что-то, особенно маленьких детей или растения, и помогать развиваться; вынашивать, выращивать, воспитывать

wondrous - чрезвычайно и удивительно хороший; чудесный, удивительный

pristine - оригинальный и чистый, неиспорченый и неизношенный от использования; нетронутый, первозданный

much to the relief of someone - к большому облегчнию для кого-то

a grub - личинка жука

a maggot - личинка мухи

a digestive tract - пишеварительный тракт

to furnish something - поставить или предоставить что-то необходимое

dormant - неактивный и нерастущий в данный момент, но имеющий возможность быть активным в более позднее время; спящий, в спячке, дремлющий, бездействующий

virulent - вирулентный

to bond something to something - склеивать материалы вместе, особенно с помощью клея

persistent - длящийся долгое время или от которого трудно избавиться; устойчивый, неотвязный

short-handed / shorthanded - нуждающийся в рабочей силе

to punch someone's clock - побить кого-то с целью убить; надавать по голове (informal)

a myelination - миелинизация

cranial - относящийся к черепу, черепной

to enervate - заставить кого-то чувствовать себя слабым и без энергии; обессилить

to ransack something - полностью обыскать место таким образом, чтобы оставить беспорядок и нанести ущерб

a forbearance - качество терпеливости и умения прощать кого-то или владеть собой в трудной ситуации; снисходительность

stratospherically - в очень высокой степени; стратосферно (informal)

My cup runneth over - моя чаша переполнена; это цитата из еврейской Библии (Псалтирь: 22:5) и означает «у меня более чем достаточно для моих нужд»

to tend someone or something - заботиться о ком-то или чем-то; ухаживать

to entrust someone to do something - дать кому-то какую-то вещь или поручение, за которое этот кто-то будет ответственен; доверить, поручить, возложить

a sightseeing - осмотр достопримечательностей или других мест

a footnote - 1) заметка, напечатанная внизу страницы, которая дает дополнительную информацию о чем-то, что было написано на этой странице; сноска, примечание
2) событие, субъект или деталь, которые не имеют большой важности

a handmaiden - слуга женского пола; служанка

to eradicate something - избавиться от чего-то полностью или уничтожить что-то очень плохое; искоренить

to thrive - говоря про ребенка, животного или растение, расти или развиваться продуктивно или энергично; процветать, преуспевать

unruly - трудно контролируемый и часто не подчиняющийся правилам; непокорный, непослушный

to co-opt - кооптировать

a speck of something - очень маленькая отметина, кусочек или количество; пятнышко, частичка, крупинка

comforting - делающий вас чувствовать себя менее грустным или беспокойным; утешительный

to sever - сломать или отделить, особенно путем разрезания

to behold something - созерцать что-то

a pool cue - кий

redundant - ненужный, потому что это больше, чем нужно; излишний, избыточный, чрезмерный

correspondingly - соответственно

presumably - предположительно, по-видимому

a nourishment - пища или другие вещества, необходимые для роста, здоровья и хорошего состояния; питание, пища

a shirker - уклоняющийся от работы человек; прогульщик

to remedy something - сделать что-то, чтобы исправить или улучшить то, что неправильно (например, ситуацию); исправить

to recon in force - произвести разведку боем

a remedy - успешный способ лечения болезни, решения проблемы, ситауции или трудности

a remorse - чувство грусти и сожаления о том, что вы сделали; угрызение совести, раскаяние

to wrest something from someone - получить что-то с усилием или трудом; вырвать, отобрать (например, акционеры планируют отобрать контроль над компанией у нынешних директоров)

to mock someone or something - смеяться над кем-то или чем-то, часто копируя их в смешной и недоброй манере; издеваться, высмеивать

an eminence - известность или признанное превосходство, особенно в определенной сфере или профессии; превосходство

a scapegoat - козел отпущения

a gig - работа, работенка (informal)

to wire something up to something - установить внутри чего-то или какого-то места провода, чтобы обеспечить питание, доступ в Интернет или прямую линию связи; подключить что-то (например, подключить наш дом к интернету)

a sorrow - чувство великой печали; печаль, горе, скорбь

a toaster - тип транспортного средства с внешним видом, похожим на тостер (informal)

impervious to something - невосприимчивый к чему-то (например, к критике)

frantically - 1) торопливо и в состоянии волнения или растерянности; лихорадочно
2) почти неконтролируемым образом из-за сильных эмоций, таких как беспокойство; отчаянно

a germanium - германий

a trace element - рассеянный элемент

a propagation - акт или действие по распространению чего-то; распространение, размножение, разведение

as of this time - на этот раз

to impede something - замедлить что-то или помешать выполнению какого-то действия с прежней скоростью; препятствовать, мешать, затруднять

to desist - перестать что-то делать, особенно то, что кто-то другой не хочет, чтобы вы делали; воздерживаться, прекращать, переставать

a rent-a-cop - сотрудник службы безопасности (например, охранник), не являющийся сотрудником полиции, часто используется пренебрежительно

to comply - действовать в соответствии с приказом, набором правил или запросом; подчиняться, исполнять или соблюдать приказы

ick - используется для выражения чувства шока или неприязни, которое заставляет вас чувствовать себя плохо; фу

to rig something up - быстро сделать часть оборудования из любых подручных материалов; построить наспех, смастерить, соорудить

to dawdle - делать что-то или идти куда-то очень медленно, занимая больше времени, чем необходимо; бездельничать; зря тратить время

a vermin - мелкое животное и насекомое, которое может быть вредным и с которым трудно бороться, когда он появляется в большом количестве; паразит, вредитель

revolting - отвратительный, отталкивающий

to abide someone or something - терпеть или выносить кого-то или чего-то (informal)

benign - говоря про опухоли или наросты, доброкачественный

a lattice - конструкция, сделанная из полос дерева или другого материала, которые пересекаются друг с другом с промежутками между ними, обычно используемая в качестве садовой решетки; решетка

a blackout - время, когда весь свет должен быть отключен по закону, или когда нет света или электричества из-за отключения электричества; отключение электроэнергии

to fritz out - стать неработающим, выйти из строя

a humidity - влажность

a grudge against someone - сильное чувство гнева и неприязни к человеку, который, по вашему мнению, плохо с вами обращался, особенно такое, которое длится долгое время; сильная обида

armed to the hilt / the teeth - вооруженный до зубов

a bedfellow - человек, связанный с другим человеком в определенной деятельности; сотоварищ, партнер

an interment - погребение или захоронение кого-то

an interment site - место погребения или захоронения

(every) now and then - время от времени

outright - открытый и прямой, без попыток скрыть; откровенный, неприкрытый (например, откровенная кража)

an outright theft - откровенная кража

sensual - выражающий или предполагающий физическое, особенно сексуальное, удовольствие или удовлетворение; чувственный, плотский

a maroon - a moron

to be in complete accord with someone or something - быть полностью согласным с кем-то или чем-то

to come over to someone or something - перейти на другую сторону в разногласиях, конкуренции и так далее

bodily - имеющий отношение к человеческому телу; телесный

a recreation - что-то, что делается для удовольствия или для расслабления, или такие действия в целом; отдых, развлечения

a lapdog - болонка

a shunt - шунт

to cobble something - сделать или собрать что-то грубо или поспешно

to ring someone or something by/with someone or something - окружить кого-то или что-то кем-то или чем-то

a receptacle - контейнер, используемый для хранения или помещения предметов; вместилищ, приемник

-fold - в количестве, умноженном на сколько-то (например, twenty-fold - двадцатикратный)

a stub - короткий конец, который остается после того, как основная часть чего-то была использована или удалена, как у карандаша; корешок

peculiar - необычный и странный, иногда неприятным образом; своеобразный, специфический

a predisposition - состояние склонности вести себя определенным образом или страдать от определенного заболевания; предрасположенность

a crevice - небольшая узкая трещина или пространство, особенно на поверхности скалы; расщелина

to run rampant - быть очень распространенным или распространяться так быстро, что это трудно контролировать

a weave - то, как была сткана ткань; плетение

to hang back - 1) ждать, прежде чем что-то делать, особенно когда другие уже начали; отставать
2) медлить с выполнением чего-то, часто из-за страха или неуверенности в себе; робеть, не решаться

eminently - в заметной степени

to root someone or something out - 1) найти кого-то или что-то после долгих поисков
2) найти и удалить кого-то или что-то

to enlist someone - попросить и получить помощь или поддержку от кого-то; заручиться поддержкой, завербовать, привлечь на свою сторону

a monkey wrench - разводной ключ

to steel oneself for something - подготовить себя к чему-то трудному или неприятному; наполнить себя решимостью и мужеством

to quake at someone's power - дрожать от страха от чьей-то силы

umbilical - 1) относящийся к пупку или используемый в области пупка
2) относящийся к центральной области живота

to go up - быть в состоянии постройки, строится (например, здание строится)

an offspring - детеныш животного или человека; отпрыск, потомок

to rupture something - заставить что-то взорваться, сломаться или разорваться

sympathetic - относящийся к, производящий или обозначающий эффект, который возникает в ответ на подобное действие в другом месте; ответный

to presume to do something - сделать что-то, зная, что не имеете на это право; допускать, позволять себе

a guidance - помощь и совет о том, как что-то сделать или о том, как решать проблемы, связанные с вашей работой, образованием или личными отношениями; рекомендация, руководство

to be running scared - бояться того, что кто-то может с вами сделать что-то или что что-то может случиться с вами; бояться осознания того, что ваш опонент в чем-то лучше и сильнее вас; быть запуганным своим соперником; быть в страхе своего соперника, как будто вы хотите бежать или сдаться

a residue - часть, которая осталась после того, как основная часть исчезла или была удалена, или вещество, оставшееся после химического процесса, такого как испарение; остаток, останки

conventional - говоря про оружие, неядерное, обычное

to get a head start - 1) начать какую-то соревновательную деятельность, особенно гонку, до официального времени старта других участников
2) начать какую-то задачу или деятельность в более раннее время, чем обычное или необходимое
3) иметь или получать преимущество, облегчающее выполнение или достижение успеха в какой-то задаче или деятельности

uncharted - говоря про территорию, неописанная, неимеющая карту и неизведанная

to scare someone out of someone's mind - шокировать или напугать кого-то очень внезапно или сильно, здесь есть гиперболический намек на то, что человек настолько сильно напуган, что может сойти с ума

a tingle - покалывание

vile - очень неприятный, аморальный и неприемлемый; гнусный, отвратительный

a putrescence - состояние гниения

a meson - мезон

a coil - катушка

a omniscience - состояние, при котором вы все знаете; всеведение, всезнание

a strut - прочный стержень, обычно сделанный из металла или дерева, который помогает скрепить что-то, например, транспортное средство или здание; распора, стойка, подпора

a bender - запой

to be on a bender - быть в запое

to dwindle - стать меньше по размеру или количеству; сокращаться, терять значение, уменьшаться, истощаться

a progeny - молодняк или потомство человека, животного или растения

to render someone or something +adjective - заставить кого-то или что-то находиться в определенном состоянии

wayward - делающий только то, что он хочет, и часто менять свое поведение таким образом, чтобы это было трудно контролировать; своенравный, изменчивый, непостоянный

a treachery - поведение, которое обманывает или является не лояльным к тому, кто вам доверяет; предательство

a rear of something - задняя или тыловая часть чего-то (например, дома)

an insolence - грубое поведение, не демонстрирующее уважения; дерзость, наглость

effectively - используется, когда вы описываете реальный результат ситуации; фактически, по-факту

a rapture - чрезвычайное удовольствие и счастье или волнение; восторг, восхищение, упоение

to let the genie (of something) out of the bottle - позволить произойти чему-то, что не может быть остановлено; выпустить джина из бутылки

to hold sway somewhere - иметь власть или очень сильное влияние где-то; господствовать

to block something out - препятствовать способности получать или запоминать что-то

to thread - двигаться вперед, часто меняя направление, чтобы избежать людей или вещей; протискиваться, пробираться

a blockage - что-то, что останавливает прохождение чего-то другого, или действие по остановке прохождения чего-то; блокировка, препятствие, закупорка

a cluster of something - группа близких друг к другу предметов, иногда окружающих что-то; скопление

to contract - стать короче, уже или вообще меньше по размеру; сокращаться, сжиматься

сonversely - и наоборот

grinding - говоря про звуки, неприятно грубый или раздражающий для слуха и скрежечущий; похожий на грубый звук шлифования чего-то

an expanse - большой открытый участок земли, воды или неба; простор, раздолье

before long - вскоре

a compartment - отдельная часть предмета мебели, оборудования или контейнера определенного назначения; отделение, отсек, камера

to sequester something - отделить или хранить вредное вещество, такое как углекислый газ, таким образом, чтобы обеспечить его безопасность; пошлощать, изолировать (например, деревья поглощают углерод)

a substitute - вещь или человек, который используется вместо другой вещи или человека; замена, заменитель

a compassion - сострадание, сочувствие

burly - говоря про человека, большой и сильный; крепкий

tubular - сделанный или выглядящий в форме трубы; трубчатый, трубовидный, цилиндрический

hulking - большой, тяжелый и неуклюжий; неповоротливый, громадный

intimately - 1) интимно
2) очень детальным или глубоким образом

strike that - забудьте, что я (только что) сказал

single-celled - одноклеточный

bristling - ощетиневшийся

a moan - долгий низкий звук боли, страдания или другой сильной эмоции; стон

to enact something - сделать какую-то идею или правило законом; ввести в действие

to enact someone's will - исполнять чью-то волю

to snuff someone out - убить кого-то (informal)

to part ways - закончить отношения, покинуть друг друга, разойтись

to run someone's errand / errands for someone - пойти, обычно на небольшую прогулку или путешествие, чтобы купить для кого-то что-то или сделать что-то для кого-то

to set/put someone's mind at ease/rest - перестать беспокоиться; расслабиться

alarming - вызывающий тревогу, тревожный

a weaponry - оружие в общем; вооружение

wretched - несчастный, жалкий, никудышный (используется для выражения гнева, когда происходит что-то раздражающее, например, моя несчастная машина снова сломалась)