--------------------------------------------------------- LEVEL 01 MEDICAL ---------------------------------------------------------

a critter - название любого живого существа, от волка до паука (informal version of creature)

a disruption - прерывание работы системы, процесса или события; сбой, срыв

to pull something off - справиться с каким-то сложным делом

a goon - 1) жестокий преступник, которому платят за причинение вреда или угрозы людям; 2) глупый человек

an exec - руководитель

to swing something - договориться о получении или достижении чего-либо, убеждая людей или действуя слегка нечестно

Even so - Тем не менее

fumbling - делающий что-то неуклюже или неловко

VP - вице-президент

a corp VP - вице-президент корпорации

there is no telling what will happen - неизвестно, что произойдет

a maintenance - обслуживание (например, техническое)

a hatch - люк, шлюз

a grating - сооружение из металлических стержней, закрывающее отверстие, особенно в земле над водостоком; решетка

a closet - 1) чулан 2) стенной шкаф 3) уборная

to close down on somebody - закрывать или изолироваться от кого-то, или изолировать от себя кого-то

to hold on to something - удерживать или держать над чем-то сильный контроль (например, над территорией), зачастую на большее время, чем ожидается

somnolent - вызывающий сон, усыпляющий, коматозный

a suite - набор смежных номеров, особенно в отеле; апартаменты

a quadrant - квадрант, сектор

a recon - поход в разведку

it may be an academic point - это может остаться только теорией (то есть условия не позволяют что-то проверить на практике или реализовать в действительности)

unsettling - тревожный, вызывающий беспокойство

a deformity - деформация (например, тела)

to override - измененить управление какой-либо машиной или системой в особых ситуациях, особенно меняя с автоматического управления на управление человеком

a safety override code - код отключения режима безопасности

a malfunction - неисправность

to manifest - ясно показывать, проявлять или волеизъявлять что-то при помощи каких-то действий

to have clearance to something - иметь авторизованный доступ к чему-то

a security hazard - угроза безопасности

to be holed up in somewhere - засесть где-то, обустроиться в какой-то территории

to scavenge for something - искать и собирать (все, что можно использовать) из выброшенных отходов

to hold someone or something off - не давать достичь успеха тому, кто пытается атаковать или победить вас; сдерживать, удерживать

a wiring panel - монтажная или проводная панель для управления чем-то

a strain - штамм (вируса)

to facilitate something - сделать что-то возможным или более легким; поспособствовать или посодействовать чему-то; упростить или облегчить что-то; продвинуть выполнение какого-то 
дела

to sanitize something of something - очистить чего-то от чего-то (например, территорию от заражения)

a domain - владение, то есть территория, которая управляется или контролируется государством или каким-либо правителем

a tachyon - тахион; гипотетическая частица, которая движется быстрее скорости света

a probe - зонд

to try for something - сделать попытку или усилие достать или заполучить что-то

--------------------------------------------------------- LEVEL 02 RESEARCH --------------------------------------------------------- 

preliminary - предварительный

a survey - измерение и запись деталей участка земли; межевание

a profit projection - прогноз прибыли

a mining activity - горнодобывающее предприятие

a legality - соотвествие закону или приверженность к нему

to impose - навязать, продиктовать, облажить или официально принудить к соблюдению или принятию каких-то правил, налогов, наказаний и так далее

to sneak by someone or something - проскользнуть мимо кого-то или чего-то

to stand a chance - иметь шанс на успех

a power outage - какая-либо авария в энергосистеме; всплеск энергии, перебои в электричестве, отключение питания

a circuit breaker - автоматический выключатель (например, питания)

to bring something up - восстановить что-то после того, как это что-то перестало работать (например, подача энергии)

a power fluctuation - колебания энергии

of all people - используется, чтобы подчеркнуть, что какой-то конкретный человек из всех возможных вариантов - это человек, от которого больше всего или меньше всего ожидается
какое-то поведенение

a tumor - опухоль

a residential zone - жилая зона

burgeoning - расцветающий, быстро набирающий рост или силу, процветающий

to careen - быстро двигаться вперед, двигаясь из стороны в сторону

a whim - каприз

a mound - 1) округлая куча грязи, песка, камней или другого материала или приподнятый участок земли, курган, насыпь 2) округлая масса чего-то

to whimper - издавать серию слабых слабых звуков, выражающих боль или несчастье, особенно говоря про животных; скулить, ныть, хныкать

to be onto something - иметь информацию, которая поможет вам сделать важное открытие или которая имеет важное значение в какой-то ситуации

an energy-drain mine - мины понижения энергии

an admin-sec office - офис администратора безопасности

a screening room - кинозал

a rad-count - полученная доза радиации за какой-то период

to make something/someone break out - 1) провоцировать появление сыпи или пятен на коже 2) провоцировать кого-то на тошноту

an enviro-suit / an environmental protection suit - защитный костюм от воздействий окружающей среды (могут защищать от радиации и биологического загрязнения)

a bio-suit - защитный костюм от воздействий окружающей среды (могут защищать только от биологического загрязнения ???)

to deduce - прийти к ответу или принять решение, тщательно обдумав известные факты; проследить за чем-то и сделать вывод о чем-то или вывести что-то

an earthly life - земная жизнь, все живое на планете Земля

festering - гнойный, гноящийся

gibbering - говорящий быстро и неразборчиво, обычно из-за страха или шока; тараторящий, бормотающий

pustulent / pustulant - производящий или покрытый пустулами

a plea - мольба

a reaver / a reiver - рейдер, разбойник, грабитель, похититель

a cortex - кора головного мозга

--------------------------------------------------------- LEVEL R REACTOR --------------------------------------------------------- 

a schematic - схема чего-либо (например, этажа)

to strive - прилагать большие усилия, чтобы добиться чего-то; стараться, бороться, состязаться

an interloper - человек, который оказывается в месте или ситуацию, где он нежелателен или считается чужим; нарушитель

an interlock - устройство или механизм для соединения или координации функционала различных компонентов

to boast - хвастаться гордиться

a suspension - временное предотвращение чего-либо от продолжения работы

state-of-the-art - самый продвинутый на данный момент

a flechette - флешет

in the event that ... - на случай, если ...

to employ something - найти применение чему-то, использовать, применить

to spike - достигать каких-то пиковых значений какой-либо характеристики

a rash - сыпь, кожная сыпь

impudent - не проявляющий должного уважения к другому человеку; дерзкий

to avenge oneself on someone - мстить кому-то

to feed on something - говоря про животных, питаться какой-то едой на регулярной основе

for the remainder of your life - на всю оставшуюся жизнь

to meddle - вмешаться

a conflagration - обширный пожар, который уничтожает большую часть земли или собственности; пожарище

--------------------------------------------------------- LEVEL 3 MAINTENANCE ---------------------------------------------------------

repulsor - репульсорный; работающий на антигравитационных технологиях

a shaft - длинное, узкое и обычно вертикальное отверстие, которое ведет к шахте, вмещает лифт в здании или обеспечивает вентиляцию; шахта

a seating - сидячие места

a viewing room - смотровая, зрительный зал

a dibs - право иметь или получать что-то от кого-то или что-то использовать; фишки

a storage compartment - отделение для хранения вещей

a closet - шкаф или небольшая комната с дверцей, используемая для хранения вещей, особенно одежды

a relay - реле

give me a holler ... - дайте мне знать, что ... (informal)

to divert - 1) заставить что-то или кого-то изменить направление, перенаправить 2) использовать что-то для другой цели, перенаправить

a lackey - лакей

--------------------------------------------------------- LEVEL 4 STORAGE ---------------------------------------------------------

a catwalk - 1) платформа, переходящая в зрительный зал, по которой проходят модели, чтобы продемонстрировать одежду на показах мод; подиум 2) узкая дорожка или открытый мост, 
особенно в промышленном сооружении

a plastique - пластическая взрывчатка

to gash up someone's stomach - 1) нанести глубокую рану кому-то в живот 2) заставить чей-то живот выворачиваться наизнанку

to spew something - обильно выплевывать, извергать или изрыгать что-то

--------------------------------------------------------- LEVEL 5 FLIGHT DECK ---------------------------------------------------------

to jettison something or someone - выбросить кого-то или что-то за борт

to take something offline - отключить что-то

by the minute - каждую минуту

a fuse - предохранитель

to get up something - организовать что-то, попросив разных людей принять в этом участие или оказать помощь; поднять (например, поднять временные сервера для организации)

fidgety - суетливый, ерзающий; вызывающий небольшие неудобства

to reel from something - оправляться эмоционально или отходить от чего-то (например, от какого-нибудь страшного проишествия)

to go bananas - сойти с ума, съехать с катушек

a bearing - подшипник

shot - говоря про механизмы или их части, испорченный или изношенный (informal)

a convection - конвекция

a convection shaft - конвекционная шахта

to nail someone to the wall - заставить кого-то страдать или наказать кого-то, особенно сильно сердясь на него

a cover-up - попытка помешать людям узнать правду о серьезной ошибке или преступлении; укрывательство, сокрытие

to oust someone - выгнать или изгнать кого-то с должности или места

a life pod - спасательная капсула

funny - странный, удивительный, неожиданный или трудный для объяснения или понимания

to take something offline - выключить что-то

--------------------------------------------------------- LEVEL 6 EXECUTIVE ---------------------------------------------------------

a dormitory - большая комната с множеством кроватей, например, в школе-интернате; общежитие

to ride something off - отправиться куда-то из какого-то места на транспортном средстве или на животном

good riddance to someone - грубый способ сказать, что вы рады, что кто-то ушел или, что вы от кого-то избавились; скатертью дорога

to hustle over to somewhere - побежать быстро куда-то, поторопиться

to keep someone on ice - временно откладывать взаимодействие с каким-то человеком; попридержать на будущее

Achilles heel - Ахилесова пята

mercantile - 1) имеющий отношение к торговле; торговый, коммерционный, коммерческий 2) меркантильный

a facility - место, удобства или часть оборудования, предназначенные для определенной цели; объект, установка, сооружение, предприятие

a crawlway - низкий проход (как в пещере), по которому можно пройти только ползком; подземный ход

to cut across - идти прямо вместо того, чтобы обходить; срезать, пойти напрямую

to be broken up by something - состоять из нескольких частей, быть разбитым на состовляющие (например, этаж разбит на несколько секций)

a dorm - dormitory (informal)

a woodland animal - лесное животное

to emerge + adjective - прийти к концу трудного периода в жизни в каком-то состоянии (например, он вышел из скандала невридимым)

a lounge - общественное помещение, как в отеле, театре или клубе, где можно посидеть и расслабиться; комната для отдыха

a terminus - конечная установка

to urge extreme caution - призывать к крайней осторожности

an attitude jet - маленький реактивный двигатель для регулировки ориентации космического корабля в пространстве

a beneficence - щедрое даяние, или качество быть щедрым и делать добро; благодеяние

bothersome - вызывающий проблемы, надоедливый

--------------------------------------------------------- LEVEL 7 ENGINEERING ---------------------------------------------------------

a psyche - человеческая душа, разум или дух

content - довольный своим положением и не надеющийся на перемены или улучшения

an irritant - раздражитель, что-то или кто-то раздражающий

to squirm - извиваться или крутить тело из стороны в сторону, особенно в результате нервозности или дискомфорта

an isolinear chipset - изолинейный чипсет

serenely - мирным и спокойным образом, безмятежно

the brass - начальство (informal military slang)

a sysop - a system operator (informal)

--------------------------------------------------------- LEVEL 8 SECURITY ---------------------------------------------------------

spokes-on-a-wheel - спицы-на-колесе

a comprehension - способность, что-то понимать; понимание, осознание

to rewire - провести новую систему электрических проводов в здании или машине; перемонтировать, перепрошить

a surveillance - пристальное наблюдение, особенно за подозреваемым в шпионаже или преступником

to bath something or someone in something - искупать или омыть что-либо или кого-либо чем-то

a detachment - группа солдат, которые отделены от основной группы для выполнения определенной задачи

to pester - вести себя раздражающе по отношению к кому-либо, постоянно делая или прося что-то; докучивать, приставать

a scrambler - электронное устройство, которое шифрует радио или телефонные сообщения; шифратор

to oppose someone or something - не соглашаться с чем-то или кем-то, часто путем разговоров или борьбы; выступать против