a globe - глобус, мир, земной шар

to break net - прервать вещание

an uplink - линия связи для передачи сигналов на спутник, космический корабль или самолет

to bring something to the brink of something - привести что-то на грань чего-то

a period - промежуток времени, потраченный на один урок в школе; урок

a graduating senior - выпускающийся старшеклассник ???

way to go! - используется, чтобы сказать кому-то, что он сделал хорошо, или используется с юмором, когда кто-то сделал что-то глупое

to fish for something - просить или пытаться получить что-то, например, похвалу или внимание, косвенным образом; преследовать что-то косвенно, часто комплименты, например, говоря о себе негативные вещи

selfless - заботящийся больше о том, что нужно и чего хотят другие люди, а не о том, что нужно и чего хочет сам

a spore - спора

psychic - экстрасенсорный

to bug someone - раздражать или беспокоить кого-либо

a grub - молодое насекомое, только что вышедшее из яйца и похожее на маленького толстого червя; личинка

to get off someone's leg - отстать от чьей-то ноги

a touchdown - тачдаун

all's fair in love and war - в любви и на войне все средства хороши

hut - используется в американском футболе как сигнал к началу игры

to run out - говоря про запасы, ресурсы или время, заканчиваться

a rook - 1) грач 2) ладья

to fake left - двигаться влево, чтобы отвлечь на себя внимание противника в футболе

to go long - в футболе, бежать далеко от человека, бросающего мяч, чтобы получить дальнюю передачу

Flip Six Three Hole - увернуться от троих проитивников, перепрыгнув через них

to drift - отвлекаться

a screen - ситуация в футболе, когда один или несколько игроков из атакующей команды выстраиваются в линию перед квотербеком или другим игроком, у которого есть мяч, чтобы защитить его от перехватчиков команды соперника

mushy - через чур эмоциональный

to presume - считать что-то правдой, потому что это весьма вероятно так, хоть вы и не уверены в этом; полагать, предполагать

to apply to do something / for something - запросить что-то, обычно официально, особенно в письменной форме или отправив форму

to exaggerate - преувеличивать

no hard feelings - без обид

a grinder - мясорубка

to go for something - согласиться или пойти на что-то

that's all there is to it - используется, чтобы сказать, что в объекте обсуждения больше нечего добавить; вот и все на этом; вот и все; на этом все

cut off / cutoff - изолированный от кого-то или чего-то или больше неимеющий доступа к кому-то или чему-то

to try something on for size - протестировать что-то или подумать над какой-то идеей, чтобы решить, работает ли она или можно ли ее использовать

to conduct something - организовывать и осуществлять определенную деятельность; проводить

